*aa = *aa-ET = aa-Latn = aa-Latn-ET
*aa-DJ = aa-Latn-DJ
aa-Ethi = aa-Ethi-ET
aac = aac-PG = aac-Latn = aac-Latn-PG
aae-Grek = aae-Grek-IT
aae-Latn = aae-Latn-IT
aai = aai-PG = *aai-Latn = aai-Latn-PG
aak = aak-PG = *aak-Latn = aak-Latn-PG
aal-Latn = aal-Latn-CM
aap = aap-BR = aap-Latn = aap-Latn-BR
aat-Grek = aat-Grek-GR
aau = aau-PG = *aau-Latn = aau-Latn-PG
aaw = aaw-PG = aaw-Latn = aaw-Latn-PG
aaz-Latn = aaz-Latn-ID
ab = ab-Cyrl
ab = ab-GE = ab-Cyrl = ab-Cyrl-GE
ab-Geor = ab-Geor-GE
aba-Latn = aba-Latn-CI
abc-Latn = abc-Latn-PH
abe-Latn = abe-Latn-CA
abh-Arab = abh-Arab-TJ
*abi-Latn = abi-Latn-CI
abl-Rjng = abl-Rjng-ID
abn-Latn = abn-Latn-NG
abp-Latn = abp-Latn-PH
abq-Cyrl = abq-Cyrl-RU
*abq-Latn = abq-Latn-TR
abr = abr-GH = abr-Latn = abr-Latn-GH
abs-Latn = abs-Latn-ID
abt = abt-PG = *abt-Latn = abt-Latn-PG
abu-Latn = abu-Latn-CI
abv-Arab = abv-Arab-BH
abx-Latn = abx-Latn-PH
aby = aby-PG = *aby-Latn = aby-Latn-PG
aca = aca-CO = aca-Latn = aca-Latn-CO
*acd-Latn = acd-Latn-GH
ace = ace-ID = ace-Latn = ace-Latn-ID
acf-Latn = acf-Latn-LC
ach = ach-UG = ach-Latn = ach-Latn-UG
acm-Arab = acm-Arab-IQ
acn-Latn = acn-Latn-CN
acq-Arab = acq-Arab-YE
acr = acr-GT = acr-Latn = acr-Latn-GT
act = act-NL = act-Latn = act-Latn-NL
acu = acu-EC = acu-Latn = acu-Latn-EC
acw-Arab = acw-Arab-SA
acx-Arab = acx-Arab-OM
acy-Arab = acy-Arab-CY
acy-Grek = acy-Grek-CY
acy-Latn = acy-Latn-CY
acz-Latn = acz-Latn-SD
ada = ada-GH = *ada-Latn = ada-Latn-GH
adb-Latn = adb-Latn-TL
add-Latn = add-Latn-CM
*ade-Latn = ade-Latn-TG
adh = adh-UG = adh-Latn = adh-Latn-UG
adi-Latn = adi-Latn-IN
adi-Tibt = adi-Tibt-CN
*adj-Latn = adj-Latn-CI
adl-Latn = adl-Latn-IN
ado = ado-PG = ado-Latn = ado-Latn-PG
adx-Tibt = adx-Tibt-CN
ady = ady-RU = ady-Cyrl = ady-Cyrl-RU
ady-Arab = ady-Arab-RU
ady-Latn = ady-Latn-TR
adz = adz-PG = *adz-Latn = adz-Latn-PG
ae = ae-IR = ae-Avst = ae-Avst-IR
ae-Arab = ae-Arab-IR
ae-Gujr = ae-Gujr-IR
aeb = aeb-TN = *aeb-Arab = aeb-Arab-TN
aeb-Latn = aeb-Latn-TN
aec-Arab = aec-Arab-EG
aer = aer-AU = aer-Latn = aer-Latn-AU
aeu-Latn = aeu-Latn-CN
aey = aey-PG = *aey-Latn = aey-Latn-PG
aez = aez-PG = aez-Latn = aez-Latn-PG
*af = af-Latn
*af = *af-ZA = af-Latn = af-Latn-ZA
af-Brai = af-Brai-ZA
*af-NA = af-Latn-NA
afb-Arab = afb-Arab-KW
afe-Latn = afe-Latn-NG
afo-Latn = afo-Latn-NG
afu-Latn = afu-Latn-GH
afz-Latn = afz-Latn-ID
*agc-Latn = agc-Latn-NG
agd = agd-PG = *agd-Latn = agd-Latn-PG
age = age-PG = age-Latn = age-Latn-PG
agg = agg-PG = *agg-Latn = agg-Latn-PG
agm = agm-PG = *agm-Latn = agm-Latn-PG
agn-Latn = agn-Latn-PH
ago = ago-PG = *ago-Latn = ago-Latn-PG
*agq = *agq-CM = agq-Latn = agq-Latn-CM
agr = agr-PE = agr-Latn = agr-Latn-PE
ags-Latn = ags-Latn-CM
agt-Latn = agt-Latn-PH
agu = agu-GT = agu-Latn = agu-Latn-GT
agw = agw-SB = agw-Latn = agw-Latn-SB
agx-Cyrl = agx-Cyrl-RU
agy-Latn = agy-Latn-PH
*aha-Latn = aha-Latn-GH
ahb = ahb-VU = ahb-Latn = ahb-Latn-VU
ahg-Ethi = ahg-Ethi-ET
ahk-Latn = ahk-Latn-MM
ahk-Mymr = ahk-Mymr-MM
ahk-Thai = ahk-Thai-TH
*ahl-Latn = ahl-Latn-TG
aho = aho-IN = aho-Ahom = aho-Ahom-IN
ahs-Latn = ahs-Latn-NG
aia = aia-SB = aia-Latn = aia-Latn-SB
aie = aie-PG = aie-Latn = aie-Latn-PG
aig-Latn = aig-Latn-AG
aii-Syrc = aii-Syrc-IQ
aij-Hebr = aij-Hebr-IL
aim-Latn = aim-Latn-IN
ain-Kana = ain-Kana-JP
ain-Latn = ain-Latn-JP
aio-Mymr = aio-Mymr-IN
aiw-Ethi = aiw-Ethi-ET
aiw-Latn = aiw-Latn-ET
aix = aix-PG = aix-Latn = aix-Latn-PG
*ajg-Latn = ajg-Latn-BJ
aji = aji-NC = aji-Latn = aji-Latn-NC
ajp-Arab = ajp-Arab-JO
ajt-Arab = ajt-Arab-TN
ajt-Hebr = ajt-Hebr-IL
aju-Hebr = aju-Hebr-IL
*ak = *ak-GH = ak-Latn = ak-Latn-GH
akb-Batk = akb-Batk-ID
akb-Latn = akb-Latn-ID
akc-Latn = akc-Latn-ID
ake = ake-GY = ake-Latn = ake-Latn-GY
akh = akh-PG = akh-Latn = akh-Latn-PG
akk = akk-IQ = akk-Xsux = akk-Xsux-IQ
akl-Latn = akl-Latn-PH
akp-Latn = akp-Latn-GH
akr = akr-VU = akr-Latn = akr-Latn-VU
*ala-Latn = ala-Latn-NG
ald-Latn = ald-Latn-CI
ale-Cyrs = ale-Cyrs-US
ale-Latn = ale-Latn-US
ali = ali-PG = *ali-Latn = ali-Latn-PG
alj-Latn = alj-Latn-PH
all-Mlym = all-Mlym-IN
aln = aln-XK = aln-Latn = aln-Latn-XK
aln-Brai = aln-Brai-AL
alo-Latn = alo-Latn-ID
alp-Latn = alp-Latn-ID
alq-Latn = alq-Latn-CA
als-Elba = als-Elba-AL
als-Grek = als-Grek-GR
als-Latn = als-Latn-AL
alt = alt-RU = alt-Cyrl = alt-Cyrl-RU
alt-Mong = alt-Mong-RU
alu = alu-SB = alu-Latn = alu-Latn-SB
alw-Ethi = alw-Ethi-ET
aly = aly-AU = aly-Latn = aly-Latn-AU
alz-Latn = alz-Latn-CD
*am = *am-ET = am-Ethi = am-Ethi-ET
*am = am-Ethi
am-Brai = am-Brai-ET
amc = amc-PE = amc-Latn = amc-Latn-PE
ame = ame-PE = ame-Latn = ame-Latn-PE
amf-Ethi = amf-Ethi-ET
amf-Latn = amf-Latn-ET
ami-Latn = ami-Latn-TW
amk-Latn = amk-Latn-ID
amm = amm-PG = *amm-Latn = amm-Latn-PG
amn = amn-PG = *amn-Latn = amn-Latn-PG
amo = amo-NG = amo-Latn = amo-Latn-NG
amp = amp-PG = *amp-Latn = amp-Latn-PG
amr = amr-PE = amr-Latn = amr-Latn-PE
amu = amu-MX = amu-Latn = amu-Latn-MX
amx = amx-AU = amx-Latn = amx-Latn-AU
amz = amz-AU = amz-Latn = amz-Latn-AU
an-Latn = an-Latn-ES
anb = anb-PE = anb-Latn = anb-Latn-PE
*anc-Latn = anc-Latn-NG
anh = anh-PG = anh-Latn = anh-Latn-PG
ani-Cyrl = ani-Cyrl-RU
*ank-Latn = ank-Latn-NG
anl-Latn = anl-Latn-MM
anm-Latn = anm-Latn-IN
*ann-Latn = ann-Latn-NG
ano = ano-CO = ano-Latn = ano-Latn-CO
anp-Deva = anp-Deva-IN
anr-Deva = anr-Deva-IN
anu-Ethi = anu-Ethi-ET
anu-Latn = anu-Latn-SS
anv-Latn = anv-Latn-CM
anw-Latn = anw-Latn-NG
*any-Latn = any-Latn-CI
anz = anz-PG = anz-Latn = anz-Latn-PG
aoc = aoc-VE = aoc-Latn = aoc-Latn-VE
aoe = aoe-PG = aoe-Latn = aoe-Latn-PG
aoi = aoi-AU = aoi-Latn = aoi-Latn-AU
aoj = aoj-PG = *aoj-Latn = aoj-Latn-PG
aom = aom-PG = *aom-Latn = aom-Latn-PG
aon = aon-PG = aon-Latn = aon-Latn-PG
aoz = aoz-ID = aoz-Latn = aoz-Latn-ID
apb = apb-SB = apb-Latn = apb-Latn-SB
*apc-Arab = apc-Arab-SY
apd-Arab = apd-Arab-SD
*apd-Latn = apd-Latn-SD
ape = ape-PG = *ape-Latn = ape-Latn-PG
apf-Latn = apf-Latn-PH
aph-Deva = aph-Deva-NP
apj-Latn = apj-Latn-US
apm-Latn = apm-Latn-US
apn = apn-BR = apn-Latn = apn-Latn-BR
app = app-VU = app-Latn = app-Latn-VU
apr = apr-PG = *apr-Latn = apr-Latn-PG
aps = aps-PG = *aps-Latn = aps-Latn-PG
apt-Latn = apt-Latn-IN
apu = apu-BR = apu-Latn = apu-Latn-BR
apw-Latn = apw-Latn-US
apy = apy-BR = apy-Latn = apy-Latn-BR
apz = apz-PG = *apz-Latn = apz-Latn-PG
*ar = ar-Arab
*ar = *ar-EG = ar-Arab = ar-Arab-EG
*ar-AE = ar-Arab-AE
*ar-BH = ar-Arab-BH
*ar-DZ = ar-Arab-DZ
*ar-EH = ar-Arab-EH
*ar-IQ = ar-Arab-IQ
*ar-JO = ar-Arab-JO
*ar-KM = ar-Arab-KM
*ar-KW = ar-Arab-KW
*ar-LB = ar-Arab-LB
*ar-LY = ar-Arab-LY
*ar-MA = ar-Arab-MA
*ar-MR = ar-Arab-MR
*ar-OM = ar-Arab-OM
*ar-PS = ar-Arab-PS
*ar-QA = ar-Arab-QA
*ar-SA = ar-Arab-SA
*ar-SD = ar-Arab-SD
*ar-SY = ar-Arab-SY
ar-Syrc = ar-Syrc-SA
*ar-TN = ar-Arab-TN
*ar-YE = ar-Arab-YE
arb-Arab = arb-Arab-SA
arb-Brai = arb-Brai-SA
arc = arc-IR = arc-Armi = arc-Armi-IR
arc-Nbat = arc-Nbat-JO
arc-Palm = arc-Palm-SY
are = are-AU = are-Latn = are-Latn-AU
arh = arh-CO = *arh-Latn = arh-Latn-CO
arl = arl-PE = arl-Latn = arl-Latn-PE
arn = arn-CL = arn-Latn = arn-Latn-CL
aro = aro-BO = aro-Latn = aro-Latn-BO
arp-Latn = arp-Latn-US
arq = arq-DZ = arq-Arab = arq-Arab-DZ
ars-Arab = ars-Arab-SA
arw = arw-SR = arw-Latn = arw-Latn-SR
ary = ary-MA = ary-Arab = ary-Arab-MA
arz = arz-EG = *arz-Arab = arz-Arab-EG
arz-Brai = arz-Brai-EG
*as = *as-IN = as-Beng = as-Beng-IN
*as = *as-IN = as-Beng = as-Beng-IN
*asa = *asa-TZ = asa-Latn = asa-Latn-TZ
asd = asd-PG = asd-Latn = asd-Latn-PG
ase = ase-US = ase-Sgnw = ase-Sgnw-US
*asg-Latn = asg-Latn-NG
asj-Latn = asj-Latn-CM
aso = aso-PG = *aso-Latn = aso-Latn-PG
asr-Deva = asr-Deva-IN
ass-Latn = ass-Latn-CM
*ast = *ast-ES = ast-Latn = ast-Latn-ES
asu = asu-BR = asu-Latn = asu-Latn-BR
asx = asx-PG = asx-Latn = asx-Latn-PG
asy-Latn = asy-Latn-ID
ata = ata-PG = *ata-Latn = ata-Latn-PG
atb-Latn = atb-Latn-CN
atb-Lisu = atb-Lisu-CN
atd-Latn = atd-Latn-PH
*atg-Latn = atg-Latn-NG
ati-Latn = ati-Latn-CI
atj = atj-CA = atj-Latn = atj-Latn-CA
atn-Arab = atn-Arab-IR
atq-Latn = atq-Latn-ID
att-Latn = att-Latn-PH
atu-Latn = atu-Latn-SS
atv-Cyrl = atv-Cyrl-RU
aty = aty-VU = aty-Latn = aty-Latn-VU
aua = aua-SB = aua-Latn = aua-Latn-SB
auc = auc-EC = auc-Latn = auc-Latn-EC
aud = aud-SB = aud-Latn = aud-Latn-SB
aui = aui-PG = aui-Latn = aui-Latn-PG
aul = aul-VU = aul-Latn = aul-Latn-VU
aun = aun-PG = aun-Latn = aun-Latn-PG
aup = aup-PG = aup-Latn = aup-Latn-PG
auu-Latn = auu-Latn-ID
auy = auy-PG = *auy-Latn = auy-Latn-PG
av = av-RU = av-Cyrl = av-Cyrl-RU
avi-Latn = avi-Latn-CI
avk-Latn = avk-Latn-??
*avl-Arab = avl-Arab-EG
*avn-Latn = avn-Latn-GH
avt = avt-PG = *avt-Latn = avt-Latn-PG
*avu-Latn = avu-Latn-SS
awa = awa-IN = awa-Deva = awa-Deva-IN
awb = awb-PG = *awb-Latn = awb-Latn-PG
awi = awi-PG = awi-Latn = awi-Latn-PG
awk = awk-AU = awk-Latn = awk-Latn-AU
awn-Ethi = awn-Ethi-ET
*awo-Latn = awo-Latn-NG
awu-Latn = awu-Latn-ID
awx = awx-PG = *awx-Latn = awx-Latn-PG
axk-Latn = axk-Latn-CF
ay = ay-BO = ay-Latn = ay-Latn-BO
ay = ay-Latn
*ayb-Latn = ayb-Latn-BJ
ayl-Arab = ayl-Arab-LY
ayn-Arab = ayn-Arab-YE
ayo = ayo-PY = ayo-Latn = ayo-Latn-PY
ayp-Arab = ayp-Arab-IQ
ayq = ayq-PG = ayq-Latn = ayq-Latn-PG
ayr = ayr-BO = ayr-Latn = ayr-Latn-BO
ayz-Latn = ayz-Latn-ID
*az = az-AZ = *az-Latn = *az-Latn-AZ
*az = az-IR = az-Arab = az-Arab-IR
az-Brai = az-Brai-IR
az-IQ = az-Arab-IQ
az-RU = az-Cyrl-RU
az-TR = az-Arab-TR
*azb-Arab = azb-Arab-IR
azd = azd-MX = azd-Latn = azd-Latn-MX
azg = azg-MX = azg-Latn = azg-Latn-MX
azj-Arab = azj-Arab-AZ
azj-Brai = azj-Brai-AZ
azj-Cyrl = azj-Cyrl-AM
azj-Latn = azj-Latn-AZ
azm = azm-MX = azm-Latn = azm-Latn-MX
azn = azn-MX = azn-Latn = azn-Latn-MX
azo-Latn = azo-Latn-CM
azz = azz-MX = azz-Latn = azz-Latn-MX
ba = ba-RU = ba-Cyrl = ba-Cyrl-RU
baa = baa-SB = baa-Latn = baa-Latn-SB
bag-Latn = bag-Latn-CM
bah = bah-BS = bah-Latn = bah-Latn-BS
bal = bal-PK = bal-Arab = bal-Arab-PK
ban = ban-ID = ban-Latn = ban-Latn-ID
ban-Bali = ban-Bali-ID
ban-Java = ban-Java-ID
bao = bao-CO = bao-Latn = bao-Latn-CO
bap = bap-NP = bap-Deva = bap-Deva-NP
bar = bar-AT = bar-Latn = bar-Latn-AT
*bas = *bas-CM = bas-Latn = bas-Latn-CM
*bav-Latn = bav-Latn-CM
baw-Latn = baw-Latn-CM
bax = bax-CM = bax-Bamu = bax-Bamu-CM
bax-Latn = bax-Latn-CM
*bba-Latn = bba-Latn-BJ
bbb = bbb-PG = *bbb-Latn = bbb-Latn-PG
bbc = bbc-ID = bbc-Latn = bbc-Latn-ID
bbc-Batk = bbc-Batk-ID
bbd = bbd-PG = *bbd-Latn = bbd-Latn-PG
bbj = bbj-CM = bbj-Latn = bbj-Latn-CM
bbk-Latn = bbk-Latn-CM
bbo-Latn = bbo-Latn-BF
bbq-Latn = bbq-Latn-CM
bbr = bbr-PG = *bbr-Latn = bbr-Latn-PG
bbu-Latn = bbu-Latn-NG
bbv = bbv-PG = bbv-Latn = bbv-Latn-PG
bbw-Latn = bbw-Latn-CM
bca-Hani = bca-Hani-CN
bca-Latn = bca-Latn-CN
bcb-Latn = bcb-Latn-SN
bcc = bcc-PK = *bcc-Arab = bcc-Arab-PK
bcf = bcf-PG = *bcf-Latn = bcf-Latn-PG
bch = bch-PG = *bch-Latn = bch-Latn-PG
bci = bci-CI = *bci-Latn = bci-Latn-CI
bck = bck-AU = bck-Latn = bck-Latn-AU
bcl-Brai = bcl-Brai-PH
bcl-Latn = bcl-Latn-PH
bcm = bcm-PG = bcm-Latn = bcm-Latn-PG
*bcn-Latn = bcn-Latn-NG
bco = bco-PG = *bco-Latn = bco-Latn-PG
bcp-Latn = bcp-Latn-CD
*bcq-Ethi = bcq-Ethi-ET
*bcq-Latn = bcq-Latn-ET
bcr-Latn = bcr-Latn-CA
bcu = bcu-PG = *bcu-Latn = bcu-Latn-PG
bcw-Latn = bcw-Latn-CM
bcy-Latn = bcy-Latn-NG
bcz-Latn = bcz-Latn-SN
bda-Latn = bda-Latn-SN
bdd = bdd-PG = *bdd-Latn = bdd-Latn-PG
bde-Latn = bde-Latn-NG
bdg-Latn = bdg-Latn-MY
bdh-Latn = bdh-Latn-SS
bdi-Latn = bdi-Latn-SD
bdm-Latn = bdm-Latn-TD
bdq-Latn = bdq-Latn-VN
bdr-Latn = bdr-Latn-MY
bds = bds-TZ = bds-Latn = bds-Latn-TZ
bdt-Latn = bdt-Latn-CF
bdu-Latn = bdu-Latn-CM
bdv-Orya = bdv-Orya-IN
bdy = bdy-AU = bdy-Latn = bdy-Latn-AU
*be = *be-BY = be-Cyrl = be-Cyrl-BY
*be = be-Cyrl
be-Brai = be-Brai-BY
be-Latn = be-Latn-BY
be-PL = be-Cyrl-PL
bea-Cans = bea-Cans-CA
bea-Latn = bea-Latn-CA
beb-Latn = beb-Latn-CM
bec-Latn = bec-Latn-CM
bee-Deva = bee-Deva-IN
bef = bef-PG = *bef-Latn = bef-Latn-PG
*beh-Latn = beh-Latn-BJ
bei-Latn = bei-Latn-ID
bej = bej-SD = bej-Arab = bej-Arab-SD
*bej-Latn = bej-Latn-SD
*bem = *bem-ZM = bem-Latn = bem-Latn-ZM
bem-Brai = bem-Brai-ZM
beo = beo-PG = beo-Latn = beo-Latn-PG
bep-Latn = bep-Latn-ID
beq-Latn = beq-Latn-CG
*bet-Latn = bet-Latn-CI
bev-Latn = bev-Latn-CI
bew = bew-ID = bew-Latn = bew-Latn-ID
*bex-Latn = bex-Latn-SS
bey = bey-PG = bey-Latn = bey-Latn-PG
*bez = *bez-TZ = bez-Latn = bez-Latn-TZ
bfa-Latn = bfa-Latn-SS
bfb-Deva = bfb-Deva-IN
bfd = bfd-CM = *bfd-Latn = bfd-Latn-CM
bfh = bfh-PG = bfh-Latn = bfh-Latn-PG
bfj-Latn = bfj-Latn-CM
bfm-Latn = bfm-Latn-CM
bfn-Latn = bfn-Latn-TL
bfo-Latn = bfo-Latn-BF
bfq = bfq-IN = bfq-Taml = bfq-Taml-IN
bfq-Knda = bfq-Knda-IN
bfq-Latn = bfq-Latn-IN
bfq-Qabq = bfq-Qabq-IN
bfs-Hani = bfs-Hani-CN
bfs-Latn = bfs-Latn-CN
bft = bft-PK = *bft-Arab = bft-Arab-PK
bft-Deva = bft-Deva-PK
bft-Tibt = bft-Tibt-PK
bft-x-baltia-pk = bft-x-baltia-pk = bft-x-baltia-pk = bft-x-baltia-pk
bfu-Takr = bfu-Takr-IN
bfu-Tibt = bfu-Tibt-IN
bfw-Orya = bfw-Orya-IN
bfy = bfy-IN = bfy-Deva = bfy-Deva-IN
bfz-Deva = bfz-Deva-IN
*bg = *bg-BG = bg-Cyrl = bg-Cyrl-BG
*bg = bg-Cyrl
bg-Brai = bg-Brai-BG
bg-RO = bg-Cyrl-RO
bgc = bgc-IN = bgc-Deva = bgc-Deva-IN
bgd-Deva = bgd-Deva-IN
bgg-Latn = bgg-Latn-IN
bgj-Latn = bgj-Latn-CM
bgn = bgn-PK = bgn-Arab = bgn-Arab-PK
bgn-Cyrl = bgn-Cyrl-TM
bgp = bgp-PK = bgp-Arab = bgp-Arab-PK
bgq-Deva = bgq-Deva-IN
bgr-Latn = bgr-Latn-IN
bgs-Latn = bgs-Latn-PH
bgt = bgt-SB = bgt-Latn = bgt-Latn-SB
bgw-Deva = bgw-Deva-IN
bgx = bgx-TR = bgx-Grek = bgx-Grek-TR
bgx-Latn = bgx-Latn-TR
bgz-Latn = bgz-Latn-ID
bh = bh-IN = bh-Kthi = bh-Kthi-IN
bha-Deva = bha-Deva-IN
bhb = bhb-IN = bhb-Deva = bhb-Deva-IN
bhb-Gujr = bhb-Gujr-IN
bhd-Arab = bhd-Arab-IN
bhd-Deva = bhd-Deva-IN
bhg = bhg-PG = *bhg-Latn = bhg-Latn-PG
bhh = bhh-IL = bhh-Cyrl = bhh-Cyrl-IL
bhh-Hebr = bhh-Hebr-IL
bhh-Latn = bhh-Latn-IL
bhi = bhi-IN = bhi-Deva = bhi-Deva-IN
bhj-Deva = bhj-Deva-NP
bhk = bhk-PH = bhk-Latn = bhk-Latn-PH
bhl = bhl-PG = *bhl-Latn = bhl-Latn-PG
bho = bho-IN = bho-Deva = bho-Deva-IN
bho-Kthi = bho-Kthi-IN
bho-MU = bho-Deva-MU
bhr = bhr-MG = bhr-Latn = bhr-Latn-MG
bhs-Latn = bhs-Latn-CM
bhu-Deva = bhu-Deva-IN
bhw-Latn = bhw-Latn-ID
*bhy-Latn = bhy-Latn-CD
bhz-Latn = bhz-Latn-ID
bi = bi-VU = bi-Latn = bi-Latn-VU
*bib-Latn = bib-Latn-BF
bid-Latn = bid-Latn-TD
big = big-PG = *big-Latn = big-Latn-PG
bik = bik-PH = bik-Latn = bik-Latn-PH
*bim-Latn = bim-Latn-GH
bin = bin-NG = *bin-Latn = bin-Latn-NG
bio = bio-PG = *bio-Latn = bio-Latn-PG
biq = biq-PG = biq-Latn = biq-Latn-PG
bir = bir-PG = bir-Latn = bir-Latn-PG
biu-Latn = biu-Latn-IN
biv-Latn = biv-Latn-GH
biw-Latn = biw-Latn-CM
biy-Deva = biy-Deva-IN
bja-Latn = bja-Latn-CD
bjg-Latn = bjg-Latn-GW
bjh = bjh-PG = *bjh-Latn = bjh-Latn-PG
*bji-Ethi = bji-Ethi-ET
bjj = bjj-IN = bjj-Deva = bjj-Deva-IN
bjk = bjk-PG = bjk-Latn = bjk-Latn-PG
bjn = bjn-ID = bjn-Latn = bjn-Latn-ID
bjn-Arab = bjn-Arab-ID
bjp = bjp-PG = bjp-Latn = bjp-Latn-PG
bjr = bjr-PG = *bjr-Latn = bjr-Latn-PG
*bjt-Arab = bjt-Arab-SN
bjt-Latn = bjt-Latn-SN
bjv-Latn = bjv-Latn-TD
bjw-Latn = bjw-Latn-CI
bjz = bjz-PG = *bjz-Latn = bjz-Latn-PG
*bkc-Latn = bkc-Latn-CM
bkd-Latn = bkd-Latn-PH
bkh-Latn = bkh-Latn-CM
bki = bki-VU = bki-Latn = bki-Latn-VU
bkk-x-baltia-in = bkk-x-baltia-in = bkk-x-baltia-in = bkk-x-baltia-in
bkl-Latn = bkl-Latn-ID
bkm = bkm-CM = *bkm-Latn = bkm-Latn-CM
bkq = bkq-BR = *bkq-Latn = bkq-Latn-BR
bkt-Latn = bkt-Latn-CD
bku = bku-PH = bku-Latn = bku-Latn-PH
bku-Buhd = bku-Buhd-PH
*bkv-Latn = bkv-Latn-NG
bkw-Latn = bkw-Latn-CG
bkx-Latn = bkx-Latn-TL
bky-Latn = bky-Latn-NG
bla-Cans = bla-Cans-CA
bla-Latn = bla-Latn-CA
blb = blb-SB = blb-Latn = blb-Latn-SB
ble-Latn = ble-Latn-GW
blf-Latn = blf-Latn-ID
blh-Latn = blh-Latn-LR
bli-Latn = bli-Latn-CD
blk-Mymr = blk-Mymr-MM
blm-Latn = blm-Latn-SS
*blo-Latn = blo-Latn-BJ
blr-Lana = blr-Lana-CN
blr-Latn = blr-Latn-CN
blr-Tale = blr-Tale-CN
blr-Thai = blr-Thai-TH
blt = blt-VN = *blt-Tavt = blt-Tavt-VN
blt-Laoo = blt-Laoo-LA
*blt-Latn = blt-Latn-VN
blw-Latn = blw-Latn-PH
blx-Latn = blx-Latn-PH
blz-Latn = blz-Latn-ID
*bm = *bm-ML = *bm-Latn = *bm-Latn-ML
bm-Nkoo = bm-Nkoo-ML
bmb-Latn = bmb-Latn-CD
bmh = bmh-PG = *bmh-Latn = bmh-Latn-PG
bmi-Latn = bmi-Latn-TD
bmj-Deva = bmj-Deva-NP
bmk = bmk-PG = *bmk-Latn = bmk-Latn-PG
bmm = bmm-MG = bmm-Latn = bmm-Latn-MG
bmo-Latn = bmo-Latn-CM
bmq = bmq-ML = *bmq-Latn = bmq-Latn-ML
bmr = bmr-CO = bmr-Latn = bmr-Latn-CO
bms-Latn = bms-Latn-NE
bmu = bmu-PG = *bmu-Latn = bmu-Latn-PG
bmv-Latn = bmv-Latn-CM
bmz = bmz-PG = bmz-Latn = bmz-Latn-PG
*bn = *bn-BD = bn-Beng = bn-Beng-BD
*bn = bn-Beng
bn-Brai = bn-Brai-BD
bn-Newa = bn-Newa-NP
bnb-Latn = bnb-Latn-MY
bnc-Latn = bnc-Latn-PH
*bng-Latn = bng-Latn-GQ
bni-Latn = bni-Latn-CD
bnj-Latn = bnj-Latn-PH
*bnm-Latn = bnm-Latn-GQ
bnn-Latn = bnn-Latn-TW
bno-Latn = bno-Latn-PH
bnp = bnp-PG = *bnp-Latn = bnp-Latn-PG
bns-Deva = bns-Deva-IN
bnw = bnw-PG = bnw-Latn = bnw-Latn-PG
*bo = *bo-CN = bo-Tibt = bo-Tibt-CN
bo-Marc = bo-Marc-CN
bo-Phag = bo-Phag-CN
boa = boa-PE = boa-Latn = boa-Latn-PE
bob = bob-KE = bob-Latn = bob-Latn-KE
boh-Latn = boh-Latn-CD
boj = boj-PG = *boj-Latn = boj-Latn-PG
*bom-Latn = bom-Latn-NG
bon = bon-PG = *bon-Latn = bon-Latn-PG
boq = boq-PG = boq-Latn = boq-Latn-PG
bor = bor-BR = bor-Latn = bor-Latn-BR
bot-Latn = bot-Latn-SS
bou = bou-TZ = bou-Latn = bou-Latn-TZ
bov-Latn = bov-Latn-GH
box-Latn = box-Latn-BF
boz-Latn = boz-Latn-ML
bpa = bpa-VU = bpa-Latn = bpa-Latn-VU
bpj-Latn = bpj-Latn-CD
bpp-Latn = bpp-Latn-ID
bpr-Latn = bpr-Latn-PH
bps-Latn = bps-Latn-PH
bpw = bpw-PG = bpw-Latn = bpw-Latn-PG
bpy = bpy-IN = bpy-Beng = bpy-Beng-IN
*bqc-Latn = bqc-Latn-BJ
bqg-Latn = bqg-Latn-TG
bqi = bqi-IR = bqi-Arab = bqi-Arab-IR
bqj-Latn = bqj-Latn-SN
*bqp-Latn = bqp-Latn-NG
bqs = bqs-PG = bqs-Latn = bqs-Latn-PG
bqt-Latn = bqt-Latn-CM
bqv = bqv-CI = bqv-Latn = bqv-Latn-CI
bqz-Latn = bqz-Latn-CM
*br = *br-FR = br-Latn = br-Latn-FR
bra = bra-IN = bra-Deva = bra-Deva-IN
brb-Khmr = brb-Khmr-KH
brb-Laoo = brb-Laoo-LA
brb-Latn = brb-Latn-VN
brd-Deva = brd-Deva-NP
brf-Latn = brf-Latn-CD
brg = brg-BO = brg-Latn = brg-Latn-BO
brh = brh-PK = brh-Arab = brh-Arab-PK
bri-Latn = bri-Latn-CM
brj = brj-VU = brj-Latn = brj-Latn-VU
bru-Laoo = bru-Laoo-LA
bru-Latn = bru-Latn-VN
bru-Thai = bru-Thai-LA
brv-Laoo = brv-Laoo-TH
brv-Latn = brv-Latn-TH
*brx = *brx-IN = brx-Deva = brx-Deva-IN
brx-Beng = brx-Beng-IN
brx-Latn = brx-Latn-IN
brz = brz-PG = brz-Latn = brz-Latn-PG
*bs = bs-BA = *bs-Latn = *bs-Latn-BA
*bs = bs-BA = *bs-Latn = *bs-Latn-BA
*bs-Cyrl = *bs-Cyrl-BA
bsa-Latn = bsa-Latn-ID
bsb-Latn = bsb-Latn-BN
bsc-Latn = bsc-Latn-SN
bse-Latn = bse-Latn-CM
bsh-Arab = bsh-Arab-AF
*bsj-Latn = bsj-Latn-NG
bsk = bsk-PK = bsk-Arab = bsk-Arab-PK
bsk-Latn = bsk-Latn-PK
bsn = bsn-CO = bsn-Latn = bsn-Latn-CO
bsp-Latn = bsp-Latn-GN
bsq = bsq-LR = bsq-Bass = bsq-Bass-LR
*bsq-Latn = bsq-Latn-LR
bss = bss-CM = *bss-Latn = bss-Latn-CM
*bst-Ethi = bst-Ethi-ET
bsy-Latn = bsy-Latn-MY
btd-Batk = btd-Batk-ID
bth-Latn = bth-Latn-MY
btm-Batk = btm-Batk-ID
bto = bto-PH = bto-Latn = bto-Latn-PH
bts-Batk = bts-Batk-ID
bts-Latn = bts-Latn-ID
*btt-Latn = btt-Latn-NG
btv = btv-PK = btv-Deva = btv-Deva-PK
btx-Batk = btx-Batk-ID
btx-Latn = btx-Latn-ID
bua = bua-RU = bua-Cyrl = bua-Cyrl-RU
buc = buc-YT = buc-Latn = buc-Latn-YT
bud = bud-TG = *bud-Latn = bud-Latn-TG
bud-Brai = bud-Brai-TG
buf-Latn = buf-Latn-CD
bug = bug-ID = bug-Latn = bug-Latn-ID
bug-Bugi = bug-Bugi-ID
buh-Latn = buh-Latn-CN
bui-Latn = bui-Latn-CG
buk = buk-PG = *buk-Latn = buk-Latn-PG
bum = bum-CM = *bum-Latn = bum-Latn-CM
buo = buo-PG = *buo-Latn = buo-Latn-PG
buq = buq-PG = buq-Latn = buq-Latn-PG
*bus-Latn = bus-Latn-NG
*buu-Latn = buu-Latn-CD
bux-Latn = bux-Latn-NG
buy-Latn = buy-Latn-SL
bva-Latn = bva-Latn-TD
bvb = bvb-GQ = *bvb-Latn = bvb-Latn-GQ
bvc = bvc-SB = bvc-Latn = bvc-Latn-SB
bvd = bvd-SB = bvd-Latn = bvd-Latn-SB
bvi-Latn = bvi-Latn-SS
bvm-Latn = bvm-Latn-CM
bvr = bvr-AU = bvr-Latn = bvr-Latn-AU
bvx-Latn = bvx-Latn-CG
bvz-Latn = bvz-Latn-ID
bwd = bwd-PG = *bwd-Latn = bwd-Latn-PG
bwe-Mymr = bwe-Mymr-MM
bwf = bwf-PG = bwf-Latn = bwf-Latn-PG
bwg-Latn = bwg-Latn-MZ
bwi = bwi-VE = bwi-Latn = bwi-Latn-VE
bwj-Latn = bwj-Latn-BF
bwo-Ethi = bwo-Ethi-ET
bwo-Latn = bwo-Latn-ET
bwq-Latn = bwq-Latn-BF
*bwr-Latn = bwr-Latn-NG
bwu-Latn = bwu-Latn-GH
bww-Latn = bww-Latn-CD
bwx-Latn = bwx-Latn-CN
bxa = bxa-SB = bxa-Latn = bxa-Latn-SB
bxb-Latn = bxb-Latn-SS
bxg-Latn = bxg-Latn-CD
bxh = bxh-PG = *bxh-Latn = bxh-Latn-PG
bxk = bxk-KE = bxk-Latn = bxk-Latn-KE
bxm-Cyrl = bxm-Cyrl-MN
bxm-Latn = bxm-Latn-MN
bxm-Mong = bxm-Mong-MN
bxr-Cyrl = bxr-Cyrl-RU
bya = bya-ID = bya-Latn = bya-Latn-ID
bya-Latn = bya-Latn-PH
byc-Latn = byc-Latn-NG
byd-Latn = byd-Latn-ID
bye = bye-PG = *bye-Latn = bye-Latn-PG
byh-Deva = byh-Deva-NP
*byn = byn-ER = byn-Ethi = byn-Ethi-ER
*byn-Latn = byn-Latn-ER
byr = byr-PG = *byr-Latn = byr-Latn-PG
*bys-Latn = bys-Latn-NG
byv = byv-CM = byv-Latn = byv-Latn-CM
byw-Deva = byw-Deva-NP
byx = byx-PG = *byx-Latn = byx-Latn-PG
byz = byz-PG = byz-Latn = byz-Latn-PG
*bza-Latn = bza-Latn-LR
bzd = bzd-CR = bzd-Latn = bzd-Latn-CR
bze = bze-ML = *bze-Latn = bze-Latn-ML
bzf = bzf-PG = *bzf-Latn = bzf-Latn-PG
bzh = bzh-PG = *bzh-Latn = bzh-Latn-PG
bzi-Latn = bzi-Latn-TH
bzi-Thai = bzi-Thai-TH
bzj = bzj-BZ = bzj-Latn = bzj-Latn-BZ
bzk = bzk-NI = bzk-Latn = bzk-Latn-NI
bzm-Latn = bzm-Latn-CD
bzv-Latn = bzv-Latn-CM
*bzw-Latn = bzw-Latn-NG
bzx = bzx-ML
*ca = *ca-ES = ca-Latn = ca-Latn-ES
*ca = ca-Latn
*ca-AD = ca-Latn-AD
caa = caa-GT = caa-Latn = caa-Latn-GT
cab = cab-HN = cab-Latn = cab-Latn-HN
cac = cac-GT = cac-Latn = cac-Latn-GT
cae-Latn = cae-Latn-SN
caf-Cans = caf-Cans-CA
caf-Latn = caf-Latn-CA
cag = cag-PY = cag-Latn = cag-Latn-PY
cak = cak-GT = cak-Latn = cak-Latn-GT
cal-Latn = cal-Latn-MP
cam = cam-NC = cam-Latn = cam-Latn-NC
can = can-PG = can-Latn = can-Latn-PG
cao = cao-BO = cao-Latn = cao-Latn-BO
cap = cap-BO = cap-Latn = cap-Latn-BO
caq-Latn = caq-Latn-IN
car = car-VE = car-Latn = car-Latn-VE
cas = cas-BO = cas-Latn = cas-Latn-BO
cav = cav-BO = cav-Latn = cav-Latn-BO
cax = cax-BO = cax-Latn = cax-Latn-BO
cay-Latn = cay-Latn-CA
cbc = cbc-CO = cbc-Latn = cbc-Latn-CO
cbg = cbg-CO = cbg-Latn = cbg-Latn-CO
cbi = cbi-EC = cbi-Latn = cbi-Latn-EC
cbj-Latn = cbj-Latn-BJ
cbk-Brai = cbk-Brai-PH
cbk-Latn = cbk-Latn-PH
cbl-Latn = cbl-Latn-MM
cbn-Thai = cbn-Thai-TH
cbr = cbr-PE = cbr-Latn = cbr-Latn-PE
cbs = cbs-PE = cbs-Latn = cbs-Latn-PE
cbt = cbt-PE = cbt-Latn = cbt-Latn-PE
cbu = cbu-PE = cbu-Latn = cbu-Latn-PE
cbv = cbv-CO = cbv-Latn = cbv-Latn-CO
ccc = ccc-PE = ccc-Latn = ccc-Latn-PE
cce-Latn = cce-Latn-MZ
ccg-Latn = ccg-Latn-NG
*cch = cch-NG = cch-Latn = cch-Latn-NG
cco = cco-MX = cco-Latn = cco-Latn-MX
ccp = ccp-IN = ccp-Beng = ccp-Beng-IN
ccp-Cakm = ccp-Cakm-BD
ccp-Latn = ccp-Latn-BD
cde-Telu = cde-Telu-IN
cdf-Beng = cdf-Beng-IN
cdf-Latn = cdf-Latn-IN
cdh-Deva = cdh-Deva-IN
cdh-Takr = cdh-Takr-IN
cdi-Gujr = cdi-Gujr-IN
cdm-Deva = cdm-Deva-NP
cdo-Hans = cdo-Hans-CN
cdo-Hant = cdo-Hant-CN
cdo-Latn = cdo-Latn-CN
cdz-Beng = cdz-Beng-IN
*ce = *ce-RU = ce-Cyrl = ce-Cyrl-RU
ceb = ceb-PH = ceb-Latn = ceb-Latn-PH
ceb-Brai = ceb-Brai-PH
ceg = ceg-PY = ceg-Latn = ceg-Latn-PY
cek-Latn = cek-Latn-MM
cen-Latn = cen-Latn-NG
*cfa-Latn = cfa-Latn-NG
cfm-Beng = cfm-Beng-MM
cfm-Latn = cfm-Latn-MM
cgc-Latn = cgc-Latn-PH
*cgg = *cgg-UG = cgg-Latn = cgg-Latn-UG
ch = ch-GU = ch-Latn = ch-Latn-GU
ch = ch-Latn
chd = chd-MX = chd-Latn = chd-Latn-MX
chf = chf-MX = chf-Latn = chf-Latn-MX
chj = chj-MX = chj-Latn = chj-Latn-MX
chk = chk-FM = chk-Latn = chk-Latn-FM
chm = chm-RU = chm-Cyrl = chm-Cyrl-RU
chm-Latn = chm-Latn-RU
chn-Latn = chn-Latn-US
cho = cho-US = cho-Latn = cho-Latn-US
chp = chp-CA = chp-Latn = chp-Latn-CA
chp-Cans = chp-Cans-CA
chq = chq-MX = chq-Latn = chq-Latn-MX
*chr = *chr-US = chr-Cher = chr-Cher-US
chr-Latn = chr-Latn-US
chw-Latn = chw-Latn-MZ
chx-Deva = chx-Deva-NP
chy-Latn = chy-Latn-US
chz = chz-MX = chz-Latn = chz-Latn-MX
cih-Deva = cih-Deva-IN
cim-Latn = cim-Latn-IT
cin = cin-BR = cin-Latn = cin-Latn-BR
ciw-Cans = ciw-Cans-US
ciw-Latn = ciw-Latn-US
cja = cja-KH = cja-Arab = cja-Arab-KH
cja-Cham = cja-Cham-KH
cja-Latn = cja-Latn-KH
cje-Latn = cje-Latn-VN
cjk-Latn = cjk-Latn-AO
cjm = cjm-VN = cjm-Cham = cjm-Cham-VN
cjm-Arab = cjm-Arab-VN
cjm-Latn = cjm-Latn-VN
cjo = cjo-PE = cjo-Latn = cjo-Latn-PE
cjp = cjp-CR = cjp-Latn = cjp-Latn-CR
cjs-Cyrl = cjs-Cyrl-RU
cjs-Latn = cjs-Latn-RU
cjv = cjv-PG = *cjv-Latn = cjv-Latn-PG
cjy-Hans = cjy-Hans-CN
cjy-Hant = cjy-Hant-CN
*ckb = *ckb-IQ = *ckb-Arab = ckb-Arab-IQ
*ckl-Latn = ckl-Latn-NG
ckn-Latn = ckn-Latn-MM
*cko-Latn = cko-Latn-GH
ckr = ckr-PG = ckr-Latn = ckr-Latn-PG
ckt-Cyrl = ckt-Cyrl-RU
cku-Latn = cku-Latn-US
ckv-Latn = ckv-Latn-TW
*cky-Latn = cky-Latn-NG
*cla-Latn = cla-Latn-NG
clc-Latn = clc-Latn-CA
cld-Syrc = cld-Syrc-IQ
cle = cle-MX = cle-Latn = cle-Latn-MX
clj-Latn = clj-Latn-MM
clk-Tibt = clk-Tibt-CN
clo = clo-MX = clo-Latn = clo-Latn-MX
clt-Latn = clt-Latn-MM
clu-Latn = clu-Latn-PH
cly = cly-MX = cly-Latn = cly-Latn-MX
cma-Latn = cma-Latn-VN
*cme-Latn = cme-Latn-BF
cmi = cmi-CO = cmi-Latn = cmi-Latn-CO
cmn-Bopo = cmn-Bopo-TW
cmn-Brai = cmn-Brai-CN
cmn-Hans = cmn-Hans-CN
cmn-Hant = cmn-Hant-TW
cmn-Latn = cmn-Latn-CN
cmo-Khmr = cmo-Khmr-KH
cmo-Latn = cmo-Latn-VN
cmr-Latn = cmr-Latn-MM
cna-Tibt-x-bodhi = cna-Tibt-IN-x-bodhi
cnb-Latn = cnb-Latn-MM
cng-Latn = cng-Latn-CN
cnh-Latn = cnh-Latn-MM
cni = cni-PE = cni-Latn = cni-Latn-PE
cnk-Latn = cnk-Latn-MM
cnl = cnl-MX = cnl-Latn = cnl-Latn-MX
cns-Latn = cns-Latn-ID
cnt = cnt-MX = cnt-Latn = cnt-Latn-MX
cnw-Latn = cnw-Latn-MM
co = co-FR = co-Latn = co-Latn-FR
coc = coc-MX = coc-Latn = coc-Latn-MX
cod = cod-PE = cod-Latn = cod-Latn-PE
coe = coe-CO = coe-Latn = coe-Latn-CO
cof = cof-EC = cof-Latn = cof-Latn-EC
cog-Thai = cog-Thai-TH
coh = coh-KE = coh-Latn = coh-Latn-KE
cok = cok-MX = cok-Latn = cok-Latn-MX
com-Latn = com-Latn-US
con = con-EC = con-Latn = con-Latn-EC
cop = cop-EG = cop-Copt = cop-Copt-EG
cop-Arab = cop-Arab-EG
cop-Grek = cop-Grek-EG
cot = cot-PE = cot-Latn = cot-Latn-PE
cou-Latn = cou-Latn-SN
cox = cox-PE = cox-Latn = cox-Latn-PE
cpa = cpa-MX = cpa-Latn = cpa-Latn-MX
cpb = cpb-PE = cpb-Latn = cpb-Latn-PE
cpc = cpc-PE = cpc-Latn = cpc-Latn-PE
cpg-Grek = cpg-Grek-GR
cps = cps-PH = cps-Latn = cps-Latn-PH
cpu = cpu-PE = cpu-Latn = cpu-Latn-PE
cpx-Latn = cpx-Latn-CN
cpy = cpy-PE = cpy-Latn = cpy-Latn-PE
cqd-Latn = cqd-Latn-CN
cr = cr-CA = *cr-Cans = cr-Cans-CA
cr-Latn = cr-Latn-CA
crc = crc-VU = crc-Latn = crc-Latn-VU
crh-Cyrl = crh-Cyrl-UA
crh-Latn = crh-Latn-UA
crj = crj-CA = crj-Cans = crj-Cans-CA
crj-Latn = crj-Latn-CA
crk = crk-CA = crk-Cans = crk-Cans-CA
crk-Latn = crk-Latn-CA
crl = crl-CA = crl-Cans = crl-Cans-CA
crl-Latn = crl-Latn-CA
crm = crm-CA = crm-Cans = crm-Cans-CA
crn = crn-MX = crn-Latn = crn-Latn-MX
cro-Latn = cro-Latn-US
crq = crq-AR = crq-Latn = crq-Latn-AR
crs = crs-SC = crs-Latn = crs-Latn-SC
crt = crt-AR = crt-Latn = crt-Latn-AR
crw-Latn = crw-Latn-VN
crx-Cans = crx-Cans-CA
crx-Latn = crx-Latn-CA
*cs = *cs-CZ = cs-Latn = cs-Latn-CZ
*cs = *cs-CZ = cs-Latn = cs-Latn-CZ
cs-Brai = cs-Brai-CZ
csb = csb-PL = csb-Latn = csb-Latn-PL
csh = csh-MM = csh-Mymr = csh-Mymr-MM
csh-Latn = csh-Latn-MM
csk-Latn = csk-Latn-SN
cso = cso-MX = cso-Latn = cso-Latn-MX
csv-Latn = csv-Latn-MM
csw = csw-CA = csw-Cans = csw-Cans-CA
csy-Latn = csy-Latn-MM
cta = cta-MX = cta-Latn = cta-Latn-MX
ctd = ctd-MM = ctd-Pauc = ctd-Pauc-MM
ctd-Latn = ctd-Latn-MM
cte = cte-MX = cte-Latn = cte-Latn-MX
ctg-Arab = ctg-Arab-BD
ctg-Latn = ctg-Latn-BD
ctl = ctl-MX = ctl-Latn = ctl-Latn-MX
ctn-Deva = ctn-Deva-NP
cto = cto-CO = cto-Latn = cto-Latn-CO
ctp = ctp-MX = ctp-Latn = ctp-Latn-MX
ctu = ctu-MX = ctu-Latn = ctu-Latn-MX
ctz = ctz-MX = ctz-Latn = ctz-Latn-MX
*cu = *cu-RU = cu-Cyrl = cu-Cyrl-RU
cu-Cyrs = cu-Cyrs-RU
cu-Glag = cu-Glag-BG
cua-Latn = cua-Latn-VN
cub = cub-CO = cub-Latn = cub-Latn-CO
cuc = cuc-MX = cuc-Latn = cuc-Latn-MX
cug-Latn = cug-Latn-CM
cuh = cuh-KE = cuh-Latn = cuh-Latn-KE
cui = cui-CO = cui-Latn = cui-Latn-CO
cuk = cuk-PA = cuk-Latn = cuk-Latn-PA
cul = cul-BR = cul-Latn = cul-Latn-BR
cut = cut-MX = cut-Latn = cut-Latn-MX
cuu-Lana = cuu-Lana-CN
cuv-Latn = cuv-Latn-CM
cux = cux-MX = cux-Latn = cux-Latn-MX
cv = cv-RU = cv-Cyrl = cv-Cyrl-RU
cwa = cwa-TZ = cwa-Latn = cwa-Latn-TZ
cwd-Cans = cwd-Cans-CA
cwd-Latn = cwd-Latn-CA
cwe = cwe-TZ = cwe-Latn = cwe-Latn-TZ
cwt-Latn = cwt-Latn-SN
*cy = *cy-GB = cy-Latn = cy-Latn-GB
*cy = cy-Latn
cya = cya-MX = cya-Latn = cya-Latn-MX
cyo-Latn = cyo-Latn-PH
czh-Hans = czh-Hans-CN
czh-Hant = czh-Hant-CN
czn = czn-MX = czn-Latn = czn-Latn-MX
czt-Latn = czt-Latn-MM
*da = *da-DK = da-Latn = da-Latn-DK
*da = da-Latn
da-Brai = da-Brai-DK
daa-Latn = daa-Latn-TD
dac = dac-PG = dac-Latn = dac-Latn-PG
dad = dad-PG = *dad-Latn = dad-Latn-PG
dae-Latn = dae-Latn-CM
daf = daf-CI
*dag-Latn = dag-Latn-GH
dah = dah-PG = *dah-Latn = dah-Latn-PG
dai-Latn = dai-Latn-TD
daj-Latn = daj-Latn-SD
dak = dak-US = dak-Latn = dak-Latn-US
dao-Latn = dao-Latn-MM
daq-Deva = daq-Deva-IN
dar = dar-RU = dar-Cyrl = dar-Cyrl-RU
*dav = *dav-KE = dav-Latn = dav-Latn-KE
*dbd-Latn = dbd-Latn-NG
dbf-Latn = dbf-Latn-ID
dbj-Arab = dbj-Arab-MY
dbj-Latn = dbj-Latn-MY
*dbq-Latn = dbq-Latn-CM
dby = dby-PG = dby-Latn = dby-Latn-PG
dcc = dcc-IN = dcc-Arab = dcc-Arab-IN
dcc-Deva = dcc-Deva-IN
dcr = dcr-VI = dcr-Latn = dcr-Latn-VI
dde-Latn = dde-Latn-CG
ddg-Latn = ddg-Latn-TL
*ddn-Latn = ddn-Latn-BJ
ddo-Cyrl = ddo-Cyrl-RU
dds-Latn = dds-Latn-ML
*de = *de-DE = de-Latn = de-Latn-DE
*de = de-Latn
*de-AT = de-Latn-AT
de-Brai = de-Brai-DE
*de-CH = de-Latn-CH
*de-LI = de-Latn-LI
de-Latf = de-Latf-DE
de-Runr = de-Runr-DE
dec-Latn = dec-Latn-SD
ded = ded-PG = *ded-Latn = ded-Latn-PG
def-Arab = def-Arab-IR
deg-Latn = deg-Latn-NG
del-Latn = del-Latn-US
den = den-CA = den-Latn = den-Latn-CA
den-Cans = den-Cans-CA
der-Beng = der-Beng-IN
der-Latn = der-Latn-IN
des = des-BR = des-Latn = des-Latn-BR
dev = dev-PG = dev-Latn = dev-Latn-PG
dez-Latn = dez-Latn-CD
*dga-Latn = dga-Latn-GH
dgc-Latn = dgc-Latn-PH
dgd-Latn = dgd-Latn-BF
*dgh-Latn = dgh-Latn-NG
*dgi-Latn = dgi-Latn-BF
dgk-Latn = dgk-Latn-CF
*dgl-Arab = dgl-Arab-SD
dgl-Copt-x-oldnubian = dgl-Copt-SD-x-oldnubian
dgl-Latn = dgl-Latn-SD
dgo-Arab = dgo-Arab-IN
dgo-Deva = dgo-Deva-IN
dgo-Takr = dgo-Takr-IN
dgr = dgr-CA = dgr-Latn = dgr-Latn-CA
dgw = dgw-AU = dgw-Latn = dgw-Latn-AU
dgx = dgx-PG = dgx-Latn = dgx-Latn-PG
dgz = dgz-PG = *dgz-Latn = dgz-Latn-PG
dhd-Deva = dhd-Deva-IN
dhg = dhg-AU = dhg-Latn = dhg-Latn-AU
dhi-Deva = dhi-Deva-NP
dhm-Latn = dhm-Latn-AO
dho-Deva = dho-Deva-IN
dhv = dhv-NC = dhv-Latn = dhv-Latn-NC
dhw-Deva = dhw-Deva-NP
dia = dia-PG = dia-Latn = dia-Latn-PG
dib-Latn = dib-Latn-SS
did-Latn = did-Latn-SS
dif = dif-AU = dif-Latn = dif-Latn-AU
dig = dig-KE = dig-Latn = dig-Latn-KE
dik-Latn = dik-Latn-SS
dil-Latn = dil-Latn-SD
din = din-SS = din-Latn = din-Latn-SS
dip-Latn = dip-Latn-SS
diq-Latn = diq-Latn-TR
dis-Beng = dis-Beng-IN
dis-Latn = dis-Latn-IN
diu-Latn = diu-Latn-NA
diw-Latn = diw-Latn-SS
diz-Latn = diz-Latn-CD
djc-Latn = djc-Latn-TD
*dje = *dje-NE = dje-Latn = dje-Latn-NE
*dje-Arab = dje-Arab-NE
dje-Brai = dje-Brai-NE
dji = dji-AU = dji-Latn = dji-Latn-AU
djk = djk-SR = djk-Latn = djk-Latn-SR
djk-Afak = djk-Afak-SR
djr = djr-AU = djr-Latn = djr-Latn-AU
dks-Latn = dks-Latn-SS
dkx-Latn = dkx-Latn-CM
dlg-Cyrl = dlg-Cyrl-RU
dln-Latn = dln-Latn-IN
dmg-Latn = dmg-Latn-MY
dml-Arab = dml-Arab-PK
dmo-Latn = dmo-Latn-CM
dmv-Latn = dmv-Latn-MY
dna-Latn = dna-Latn-ID
dng-Cyrl = dng-Cyrl-KG
dni-Latn = dni-Latn-ID
dnj = dnj-CI = *dnj-Latn = dnj-Latn-CI
dnk-Latn = dnk-Latn-ID
dnn-Latn = dnn-Latn-BF
dnr = dnr-PG = dnr-Latn = dnr-Latn-PG
dnt-Latn = dnt-Latn-ID
dnw-Latn = dnw-Latn-ID
dny = dny-BR = dny-Latn = dny-Latn-BR
doa = doa-PG = doa-Latn = doa-Latn-PG
dob = dob-PG = *dob-Latn = dob-Latn-PG
doc-Latn = doc-Latn-CN
doi = doi-IN = doi-Arab = doi-Arab-IN
doi-Takr = doi-Takr-IN
don = don-PG = don-Latn = don-Latn-PG
doo-Latn = doo-Latn-CD
*dop-Latn = dop-Latn-BJ
dos-Latn = dos-Latn-BF
*dow-Latn = dow-Latn-CM
drc-Latn = drc-Latn-PT
dre-Tibt = dre-Tibt-NP
drg-Latn = drg-Latn-MY
*dri-Latn = dri-Latn-NG
*drs-Ethi = drs-Ethi-ET
drt = drt-NL = drt-Latn = drt-Latn-NL
dru-Latn = dru-Latn-TW
dry-Deva = dry-Deva-NP
*dsb = *dsb-DE = dsb-Latn = dsb-Latn-DE
*dsb = *dsb-DE = dsb-Latn = dsb-Latn-DE
dsh-Latn = dsh-Latn-ET
dso-Orya = dso-Orya-IN
dsq-Arab = dsq-Arab-ML
dsq-Latn = dsq-Latn-ML
dta-Cyrl = dta-Cyrl-CN
dta-Hans = dta-Hans-CN
dta-Latn = dta-Latn-CN
dta-Mong-x-manchu = dta-Mong-CN-x-manchu
dtb-Latn = dtb-Latn-MY
dtm = dtm-ML = dtm-Latn = dtm-Latn-ML
dtp = dtp-MY = dtp-Latn = dtp-Latn-MY
dtr-Latn = dtr-Latn-MY
*dts-Latn = dts-Latn-ML
dty-Deva = dty-Deva-NP
*dua = *dua-CM = dua-Latn = dua-Latn-CM
duc = duc-PG = *duc-Latn = duc-Latn-PG
*dud-Latn = dud-Latn-NG
due-Latn = due-Latn-PH
dug = dug-KE = *dug-Latn = dug-Latn-KE
duh-Deva = duh-Deva-IN
duh-Gujr = duh-Gujr-IN
duo-Latn = duo-Latn-PH
dur-Latn = dur-Latn-CM
*dus-Deva = dus-Deva-NP
duu-Latn = duu-Latn-CN
dux-Latn = dux-Latn-ML
*dv = dv-MV = dv-Thaa = dv-Thaa-MV
*dv = dv-Thaa
dva = dva-PG = dva-Latn = dva-Latn-PG
dwr-Ethi = dwr-Ethi-ET
dwr-Latn = dwr-Latn-ET
dww = dww-PG = *dww-Latn = dww-Latn-PG
dwy = dwy-AU = dwy-Latn = dwy-Latn-AU
dya-Latn = dya-Latn-BF
dyi-Latn = dyi-Latn-CI
*dyo = *dyo-SN = dyo-Latn = dyo-Latn-SN
*dyo-Arab = dyo-Arab-SN
dyu = dyu-BF = *dyu-Latn = dyu-Latn-BF
dyu-Arab = dyu-Arab-CI
dyu-Nkoo = dyu-Nkoo-CI
*dz = *dz-BT = dz-Tibt = dz-Tibt-BT
*dz = dz-Tibt
*dzg-Latn = dzg-Latn-TD
ebk-Latn = ebk-Latn-PH
ebo-Latn = ebo-Latn-CG
ebr-Latn = ebr-Latn-CI
*ebu = *ebu-KE = ebu-Latn = ebu-Latn-KE
*ee = *ee-GH = ee-Latn = ee-Latn-GH
ee-Brai = ee-Brai-GH
efi = efi-NG = efi-Latn = efi-Latn-NG
egl = egl-IT = egl-Latn = egl-Latn-IT
ego-Latn = ego-Latn-NG
egy = egy-EG = egy-Egyp = egy-Egyp-EG
eip-Latn = eip-Latn-ID
eiv = eiv-PG = eiv-Latn = eiv-Latn-PG
eja-Latn = eja-Latn-GW
*eka-Latn = eka-Latn-NG
ekg-Latn = ekg-Latn-ID
ekk-Latn = ekk-Latn-EE
ekl-Latn = ekl-Latn-BD
*ekm-Latn = ekm-Latn-CM
eko = eko-MZ = eko-Latn = eko-Latn-MZ
eko-Arab = eko-Arab-MZ
ekr-Latn = ekr-Latn-NG
eky = eky-MM = eky-Kali = eky-Kali-MM
*el = *el-GR = el-Grek = el-Grek-GR
*el = el-Grek
el-Brai = el-Brai-GR
*el-CY = el-Grek-CY
el-Cyrl = el-Cyrl-UA
elm-Latn = elm-Latn-NG
*ema-Latn = ema-Latn-NG
emb-Latn = emb-Latn-ID
emg-Deva = emg-Deva-NP
emi = emi-PG = *emi-Latn = emi-Latn-PG
emk-Arab = emk-Arab-GN
*emk-Latn = emk-Latn-GN
emk-Nkoo = emk-Nkoo-GN
emp = emp-PA = emp-Latn = emp-Latn-PA
ems-Cyrl = ems-Cyrl-US
ems-Latn = ems-Latn-US
emx-Latn = emx-Latn-FR
*en = en-Latn
*en = *en-US = en-Latn = en-Latn-US
*en-AU = en-Latn-AU
en-Brai = en-Brai-GB
en-Dsrt = en-Dsrt-US
en-ET = en-Latn-ET
*en-GB = en-Latn-GB
*en-GU = en-Latn-GU
*en-IO = en-Latn-IO
*en-NG = en-Latn-NG
*en-PG = en-Latn-PG
en-Shaw = en-Shaw-GB
*en-ZA = en-Latn-ZA
ena = ena-PG = ena-Latn = ena-Latn-PG
enb = enb-KE = enb-Latn = enb-Latn-KE
end-Latn = end-Latn-ID
enf-Cyrl = enf-Cyrl-RU
enl = enl-PY = enl-Latn = enl-Latn-PY
*enn-Latn = enn-Latn-NG
enq = enq-PG = *enq-Latn = enq-Latn-PG
enx = enx-PY = enx-Latn = enx-Latn-PY
*eo = *eo-001 = eo-Latn = eo-Latn-001
*eo = eo-SM = eo-Latn = eo-Latn-SM
erg = erg-VU = erg-Latn = erg-Latn-VU
eri = eri-PG = *eri-Latn = eri-Latn-PG
erk = erk-VU = erk-Latn = erk-Latn-VU
ers-x-cn-ersushaba = ers-x-cn-ersushaba = ers-x-cn-ersushaba = ers-x-cn-ersushaba
*es = *es-ES = es-Latn = es-Latn-ES
*es = es-Latn
*es-419 = es-Latn-419
*es-AR = es-Latn-AR
*es-BO = es-Latn-BO
es-Brai = es-Brai-ES
*es-CL = es-Latn-CL
*es-CO = es-Latn-CO
*es-CR = es-Latn-CR
*es-CU = es-Latn-CU
*es-DO = es-Latn-DO
*es-EA = es-Latn-EA
*es-EC = es-Latn-EC
*es-GQ = es-Latn-GQ
*es-GT = es-Latn-GT
*es-HN = es-Latn-HN
*es-IC = es-Latn-IC
*es-MX = es-Latn-MX
*es-NI = es-Latn-NI
*es-PA = es-Latn-PA
*es-PE = es-Latn-PE
*es-PR = es-Latn-PR
*es-SV = es-Latn-SV
*es-UY = es-Latn-UY
*es-VE = es-Latn-VE
ese = ese-BO = ese-Latn = ese-Latn-BO
esg-Deva = esg-Deva-IN
esi-Latn = esi-Latn-US
esk-Latn = esk-Latn-US
ess-Cyrl = ess-Cyrl-US
ess-Latn = ess-Latn-US
esu = esu-US = esu-Latn = esu-Latn-US
esy-Qabr = esy-Qabr-PH
*et = *et-EE = et-Latn = et-Latn-EE
*et = et-Latn
et-Brai = et-Brai-EE
etr = etr-PG = *etr-Latn = etr-Latn-PG
ets-Latn = ets-Latn-NG
ett = ett-IT = ett-Ital = ett-Ital-IT
ett-Latn = ett-Latn-IT
*etu-Latn = etu-Latn-NG
*etx-Latn = etx-Latn-NG
*eu = *eu-ES = eu-Latn = eu-Latn-ES
*eu = eu-Latn
eve-Cyrl = eve-Cyrl-RU
evn-Cyrl = evn-Cyrl-RU
evn-Latn = evn-Latn-RU
*ewo = *ewo-CM = ewo-Latn = ewo-Latn-CM
ext = ext-ES = ext-Latn = ext-Latn-ES
eza-Latn = eza-Latn-NG
*fa = fa-Arab
*fa = *fa-IR = fa-Arab = fa-Arab-IR
*fa-AF = fa-Arab-AF
fa-TJ = fa-Arab-TJ
faa = faa-PG = *faa-Latn = faa-Latn-PG
*fab-Latn = fab-Latn-GQ
fad = fad-PG = fad-Latn = fad-Latn-PG
fag = fag-PG = *fag-Latn = fag-Latn-PG
fai = fai-PG = *fai-Latn = fai-Latn-PG
fak-Latn = fak-Latn-CM
fal-Latn = fal-Latn-CM
fan = fan-GQ = *fan-Latn = fan-Latn-GQ
fap-Latn = fap-Latn-SN
far = far-SB = far-Latn = far-Latn-SB
fat-Latn = fat-Latn
fax-Latn = fax-Latn-ES
fay-Arab = fay-Arab-IR
faz-Arab = faz-Arab-IR
fbl-Latn = fbl-Latn-PH
*ff = *ff-SN = ff-Latn = ff-Latn-SN
*ff-Arab = ff-Arab-SN
ffi = ffi-PG = *ffi-Latn = ffi-Latn-PG
ffm = ffm-ML = *ffm-Latn = ffm-Latn-ML
*ffm-Arab = ffm-Arab-ML
*fi = *fi-FI = fi-Latn = fi-Latn-FI
*fi = fi-Latn
fi-Brai = fi-Brai-FI
fia = fia-SD = *fia-Arab = fia-Arab-SD
fia-Copt-x-oldnubian = fia-Copt-SD-x-oldnubian
fia-Latn = fia-Latn-SD
*fil = *fil-PH = fil-Latn = fil-Latn-PH
fil-Tglg = fil-Tglg-PH
fip = fip-TZ = fip-Latn = fip-Latn-TZ
fir-Latn = fir-Latn-NG
fit = fit-SE = fit-Latn = fit-Latn-SE
fj = fj-FJ = fj-Latn = fj-Latn-FJ
fj = fj-FJ = fj-Latn = fj-Latn-FJ
fkk-Latn = fkk-Latn-NG
fkv-Latn = fkv-Latn-NO
*flr-Latn = flr-Latn-CD
*fmp-Latn = fmp-Latn-CM
*fo = *fo-FO = fo-Latn = fo-Latn-FO
*fo = *fo-FO = fo-Latn = fo-Latn-FO
*fod-Latn = fod-Latn-BJ
foi = foi-PG = foi-Latn = foi-Latn-PG
fon = fon-BJ = *fon-Latn = fon-Latn-BJ
for = for-PG = *for-Latn = for-Latn-PG
fos-Latn = fos-Latn-TW
*fpe-Latn = fpe-Latn-GQ
fqs = fqs-PG = *fqs-Latn = fqs-Latn-PG
*fr = *fr-FR = fr-Latn = fr-Latn-FR
*fr = fr-Latn
*fr-BF = fr-Latn-BF
*fr-BJ = fr-Latn-BJ
*fr-BL = fr-Latn-BL
fr-Brai = fr-Brai-FR
*fr-CF = fr-Latn-CF
*fr-CG = fr-Latn-CG
*fr-CI = fr-Latn-CI
*fr-CM = fr-Latn-CM
*fr-DZ = fr-Latn-DZ
fr-Dupl = fr-Dupl-FR
*fr-GA = fr-Latn-GA
*fr-GF = fr-Latn-GF
*fr-GN = fr-Latn-GN
*fr-GP = fr-Latn-GP
*fr-KM = fr-Latn-KM
*fr-LU = fr-Latn-LU
*fr-MA = fr-Latn-MA
*fr-MC = fr-Latn-MC
*fr-MF = fr-Latn-MF
*fr-MQ = fr-Latn-MQ
*fr-MR = fr-Latn-MR
*fr-NC = fr-Latn-NC
*fr-PF = fr-Latn-PF
*fr-PM = fr-Latn-PM
*fr-RE = fr-Latn-RE
*fr-SC = fr-Latn-SC
*fr-SN = fr-Latn-SN
*fr-SY = fr-Latn-SY
*fr-TD = fr-Latn-TD
fr-TF = fr-Latn-TF
*fr-TG = fr-Latn-TG
*fr-TN = fr-Latn-TN
*fr-WF = fr-Latn-WF
*fr-YT = fr-Latn-YT
frc = frc-US = frc-Latn = frc-Latn-US
frd-Latn = frd-Latn-ID
frk-Latn = frk-Latn-DE
frp = frp-FR = frp-Latn = frp-Latn-FR
frr = frr-DE = frr-Latn = frr-Latn-DE
frr = frr-Latn
frs = frs-DE = frs-Latn = frs-Latn-DE
frs = frs-Latn
*fub-Arab = fub-Arab-CM
*fub-Latn = fub-Latn-CM
*fuc-Arab = fuc-Arab-SN
*fuc-Latn = fuc-Latn-SN
fud = fud-WF = fud-Latn = fud-Latn-WF
*fue-Latn = fue-Latn-BJ
*fuf-Arab = fuf-Arab-GN
*fuf-Latn = fuf-Latn-GN
fuh-Arab = fuh-Arab-NE
*fuh-Latn = fuh-Latn-NE
fun = fun-BR = fun-Latn = fun-Latn-BR
fuq = fuq-NE = *fuq-Latn = fuq-Latn-NE
*fur = *fur-IT = fur-Latn = fur-Latn-IT
fut = fut-VU = fut-Latn = fut-Latn-VU
fuv = fuv-NG = fuv-Latn = fuv-Latn-NG
*fuv-Arab = fuv-Arab-NG
fuy = fuy-PG = *fuy-Latn = fuy-Latn-PG
fvr = fvr-SD = fvr-Latn = fvr-Latn-SD
fwe-Latn = fwe-Latn-NA
*fy = *fy-NL = fy-Latn = fy-Latn-NL
*fy = *fy-NL = fy-Latn = fy-Latn-NL
*ga = *ga-IE = ga-Latn = ga-Latn-IE
*ga = ga-Latn
ga-Latg = ga-Latg-IE
ga-Ogam = ga-Ogam-IE
*gaa = gaa-GH = gaa-Latn = gaa-Latn-GH
gab-Latn = gab-Latn-TD
gaf = gaf-PG = *gaf-Latn = gaf-Latn-PG
gag = gag-MD = gag-Latn = gag-Latn-MD
gag-Cyrl = gag-Cyrl-MD
gag-Grek = gag-Grek-MD
gah = gah-PG = *gah-Latn = gah-Latn-PG
gai = gai-PG = gai-Latn = gai-Latn-PG
gaj = gaj-PG = *gaj-Latn = gaj-Latn-PG
gal-Latn = gal-Latn-TL
gam = gam-PG = *gam-Latn = gam-Latn-PG
gan = gan-CN = gan-Hans = gan-Hans-CN
gan-Hant = gan-Hant-CN
gan-Latn = gan-Latn-CN
gas-Gujr = gas-Gujr-IN
gat = gat-PG = gat-Latn = gat-Latn-PG
gau-Telu = gau-Telu-IN
gaw = gaw-PG = *gaw-Latn = gaw-Latn-PG
gax-Latn = gax-Latn-ET
gay = gay-ID = gay-Latn = gay-Latn-ID
*gaz-Ethi = gaz-Ethi-ET
gaz-Latn = gaz-Latn-ET
gbf = gbf-PG = *gbf-Latn = gbf-Latn-PG
gbi-Latn = gbi-Latn-ID
gbj-Orya = gbj-Orya-IN
gbk-Deva = gbk-Deva-IN
gbk-Takr = gbk-Takr-IN
gbl-Deva = gbl-Deva-IN
gbl-Gujr = gbl-Gujr-IN
gbm = gbm-IN = gbm-Deva = gbm-Deva-IN
*gbo-Latn = gbo-Latn-LR
gbp-Latn = gbp-Latn-CF
gbr-Latn = gbr-Latn-NG
gbv-Latn = gbv-Latn-CF
*gby-Latn = gby-Latn-NG
gbz = gbz-IR = gbz-Arab = gbz-Arab-IR
gcc = gcc-PG = gcc-Latn = gcc-Latn-PG
gcn = gcn-PG = gcn-Latn = gcn-Latn-PG
gcr = gcr-GF = gcr-Latn = gcr-Latn-GF
gct = gct-VE = gct-Latn = gct-Latn-VE
*gd = *gd-GB = gd-Latn = gd-Latn-GB
gdb-Orya = gdb-Orya-IN
gdb-Telu = gdb-Telu-IN
gdd = gdd-PG = gdd-Latn = gdd-Latn-PG
*gde-Latn = gde-Latn-NG
gdf-Latn = gdf-Latn-NG
gdg-Latn = gdg-Latn-PH
gdl-Ethi = gdl-Ethi-ET
gdn = gdn-PG = *gdn-Latn = gdn-Latn-PG
gdq-Latn = gdq-Latn-YE
gdr = gdr-PG = *gdr-Latn = gdr-Latn-PG
geb = geb-PG = *geb-Latn = geb-Latn-PG
geh-Latn = geh-Latn-CA
*gej-Latn = gej-Latn-TG
*gel-Latn = gel-Latn-NG
ges-Latn = ges-Latn-ID
*gez = gez-ET = gez-Ethi = gez-Ethi-ET
gfk = gfk-PG = *gfk-Latn = gfk-Latn-PG
gga = gga-SB = gga-Latn = gga-Latn-SB
ggg-Arab = ggg-Arab-PK
ggn = ggn-NP = ggn-Deva = ggn-Deva-NP
ggu-Latn = ggu-Latn-CI
ggw = ggw-PG = ggw-Latn = ggw-Latn-PG
ghc-Latn = ghc-Latn-GB
ghe-Deva = ghe-Deva-NP
ghk-Latn = ghk-Latn-MM
ghs = ghs-PG = *ghs-Latn = ghs-Latn-PG
gia = gia-AU = gia-Latn = gia-Latn-AU
gid-Latn = gid-Latn-CM
gig-Arab = gig-Arab-PK
gil = gil-KI = gil-Latn = gil-Latn-KI
gim = gim-PG = *gim-Latn = gim-Latn-PG
gip = gip-PG = gip-Latn = gip-Latn-PG
git-Latn = git-Latn-CA
giz-Latn = giz-Latn-CM
gji-Latn = gji-Latn-NG
gjk = gjk-PK = gjk-Arab = gjk-Arab-PK
gjk-Gujr = gjk-Gujr-PK
*gjn-Latn = gjn-Latn-GH
gju = gju-PK = *gju-Arab = gju-Arab-PK
gju-Deva = gju-Deva-IN
gka = gka-PG = gka-Latn = gka-Latn-PG
*gkn-Latn = gkn-Latn-NG
*gkp-Latn = gkp-Latn-GN
*gl = *gl-ES = gl-Latn = gl-Latn-ES
*gl = gl-Latn
glc-Latn = glc-Latn-TD
gld-Cyrl = gld-Cyrl-RU
glk = glk-IR = *glk-Arab = glk-Arab-IR
glw-Latn = glw-Latn-NG
*gmm-Latn = gmm-Latn-CM
*gmv-Ethi = gmv-Ethi-ET
gmv-Latn = gmv-Latn-ET
gmz-Latn = gmz-Latn-NG
gn = gn-Latn
gn = gn-PY = gn-Latn = gn-Latn-PY
gna-Latn = gna-Latn-BF
gnb-Latn = gnb-Latn-IN
*gnd-Latn = gnd-Latn-CM
*gng-Latn = gng-Latn-TG
gni = gni-AU = gni-Latn = gni-Latn-AU
gnn = gnn-AU = gnn-Latn = gnn-Latn-AU
gno-Deva = gno-Deva-IN
gnw = gnw-BO = gnw-Latn = gnw-Latn-BO
goa-Latn = goa-Latn-CI
goc = goc-PG = goc-Latn = goc-Latn-PG
*god-Latn = god-Latn-CI
*gof-Ethi = gof-Ethi-ET
gof-Latn = gof-Latn-ET
gog = gog-TZ = gog-Latn = gog-Latn-TZ
goi = goi-PG = goi-Latn = goi-Latn-PG
gok-Deva = gok-Deva-IN
gol-Latn = gol-Latn-LR
gom = gom-IN = gom-Deva = gom-Deva-IN
gom-Knda = gom-Knda-IN
gom-Latn = gom-Latn-IN
gon = gon-IN = gon-Telu = gon-Telu-IN
gon-Deva = gon-Deva-IN
gor = gor-ID = gor-Latn = gor-Latn-ID
gos = gos-NL = gos-Latn = gos-Latn-NL
got = got-UA = got-Goth = got-Goth-UA
gou-Latn = gou-Latn-CM
gqa-Latn = gqa-Latn-NG
gqr-Latn = gqr-Latn-TD
gra-Deva = gra-Deva-IN
gra-Gujr = gra-Gujr-IN
grb-Latn = grb-Latn-LR
grc = grc-CY = grc-Cprt = grc-Cprt-CY
grc-Grek = grc-Grek-GR
grc-Linb = grc-Linb-GR
grg = grg-PG = grg-Latn = grg-Latn-PG
gri = gri-SB = gri-Latn = gri-Latn-SB
grt = grt-IN = grt-Beng = grt-Beng-IN
grt-Brai = grt-Brai-IN
grt-Latn = grt-Latn-IN
gru-Ethi = gru-Ethi-ET
grw = grw-PG = *grw-Latn = grw-Latn-PG
gsl-Latn = gsl-Latn-SN
gso-Latn = gso-Latn-CF
*gsw = *gsw-CH = gsw-Latn = gsw-Latn-CH
*gsw = gsw-Latn
*gu = gu-Gujr
*gu = *gu-IN = gu-Gujr = gu-Gujr-IN
gu-Brai = gu-Brai-IN
gu-Khoj = gu-Khoj-IN
gub = gub-BR = gub-Latn = gub-Latn-BR
guc = guc-CO = guc-Latn = guc-Latn-CO
*gud-Latn = gud-Latn-CI
gue = gue-AU = gue-Latn = gue-Latn-AU
guf = guf-AU = guf-Latn = guf-Latn-AU
gug = gug-PY = gug-Latn = gug-Latn-PY
guh = guh-CO = guh-Latn = guh-Latn-CO
gui = gui-BO = gui-Latn = gui-Latn-BO
guk = guk-ET = *guk-Latn = guk-Latn-ET
guk-Ethi = guk-Ethi-ET
gul-Latn = gul-Latn-US
gum = gum-CO = gum-Latn = gum-Latn-CO
gun = gun-BR = gun-Latn = gun-Latn-BR
guo = guo-CO = guo-Latn = guo-Latn-CO
gup = gup-AU = gup-Latn = gup-Latn-AU
guq = guq-PY = guq-Latn = guq-Latn-PY
gur = gur-GH = *gur-Latn = gur-Latn-GH
guu = guu-VE = guu-Latn = guu-Latn-VE
*guw-Latn = guw-Latn-BJ
*gux-Latn = gux-Latn-BF
*guz = *guz-KE = guz-Latn = guz-Latn-KE
*gv = *gv-IM = gv-Latn = gv-Latn-IM
*gv = *gv-IM = gv-Latn = gv-Latn-IM
gvc = gvc-BR = gvc-Latn = gvc-Latn-BR
gve = gve-PG = gve-Latn = gve-Latn-PG
gvf = gvf-PG = *gvf-Latn = gvf-Latn-PG
gvl-Latn = gvl-Latn-TD
gvn = gvn-AU = gvn-Latn = gvn-Latn-AU
gvo = gvo-BR = gvo-Latn = gvo-Latn-BR
gvr = gvr-NP = gvr-Deva = gvr-Deva-NP
gvs = gvs-PG = *gvs-Latn = gvs-Latn-PG
*gwc-Arab = gwc-Arab-PK
gwf-Arab = gwf-Arab-PK
gwi = gwi-CA = gwi-Latn = gwi-Latn-CA
gwr = gwr-UG = gwr-Latn = gwr-Latn-UG
gxx-Latn = gxx-Latn-CI
*gya-Latn = gya-Latn-CF
*gyi-Latn = gyi-Latn-CM
gym = gym-PA = gym-Latn = gym-Latn-PA
gyn-Latn = gyn-Latn-GY
gyr = gyr-BO = gyr-Latn = gyr-Latn-BO
gzi-Arab = gzi-Arab-IR
*ha = *ha-NG = *ha-Latn = *ha-Latn-NG
*ha-Arab = ha-Arab-NG
ha-Arab-NG
ha-Brai = ha-Brai-NG
ha-CM = ha-Arab-CM
*ha-NE = *ha-Latn-NE
ha-SD = ha-Arab-SD
haa-Latn = haa-Latn-US
hac-Arab = hac-Arab-IR
had-Latn = had-Latn-ID
hae-Latn = hae-Latn-ET
*hag-Latn = hag-Latn-GH
hah = hah-PG = hah-Latn = hah-Latn-PG
hai-Latn = hai-Latn
haj-Beng = haj-Beng-IN
haj-Latn = haj-Latn-IN
hak = hak-CN = hak-Hans = hak-Hans-CN
hak-Hant = hak-Hant-CN
hak-Latn = hak-Latn-CN
hal-Latn = hal-Latn-VN
ham = ham-PG = *ham-Latn = ham-Latn-PG
han = han-TZ = han-Latn = han-Latn-TZ
hao = hao-PG = hao-Latn = hao-Latn-PG
hap-Latn = hap-Latn-ID
haq = haq-TZ = haq-Latn = haq-Latn-TZ
har-Ethi = har-Ethi-ET
*haw = *haw-US = haw-Latn = haw-Latn-US
hay = hay-TZ = hay-Latn = hay-Latn-TZ
haz = haz-AF = haz-Arab = haz-Arab-AF
*hbb-Latn = hbb-Latn-NG
hbn-Latn = hbn-Latn-SD
hbo-Hebr = hbo-Hebr-IL
hbu-Latn = hbu-Latn-TL
hch = hch-MX = hch-Latn = hch-Latn-MX
hdn-Latn = hdn-Latn-CA
*hdy-Ethi = hdy-Ethi-ET
hdy-Latn = hdy-Latn-ET
*he = *he-IL = he-Hebr = he-Hebr-IL
*he = *he-IL = he-Hebr = he-Hebr-IL
he-Brai = he-Brai-IL
hea-Bopo = hea-Bopo-CN
hed-Latn = hed-Latn-TD
heg-Latn = heg-Latn-ID
heh = heh-TZ = heh-Latn = heh-Latn-TZ
hhi = hhi-PG = hhi-Latn = hhi-Latn-PG
hhy = hhy-PG = *hhy-Latn = hhy-Latn-PG
*hi = hi-Deva
*hi = *hi-IN = hi-Deva = hi-Deva-IN
hi-Brai = hi-Brai-IN
hi-Mahj = hi-Mahj-IN
hi-Newa = hi-Newa-IN
*hia-Latn = hia-Latn-NG
hif = hif-FJ = hif-Latn = hif-Latn-FJ
hif-Deva = hif-Deva-FJ
hif-Deva-FJ
*hig-Latn = hig-Latn-NG
hih = hih-PG = *hih-Latn = hih-Latn-PG
hil = hil-PH = hil-Latn = hil-Latn-PH
hil-Brai = hil-Brai-PH
hiw = hiw-VU = hiw-Latn = hiw-Latn-VU
hix = hix-BR = hix-Latn = hix-Latn-BR
hke-Latn = hke-Latn-CD
hkk = hkk-PG = hkk-Latn = hkk-Latn-PG
hla = hla-PG = *hla-Latn = hla-Latn-PG
hlb-Deva = hlb-Deva-IN
hlt-Latn = hlt-Latn-MM
hlu = hlu-TR = hlu-Hluw = hlu-Hluw-TR
hmb-Latn = hmb-Latn-ML
hmd = hmd-CN = *hmd-Plrd = hmd-Plrd-CN
hmd-Hmng = hmd-Hmng-CN
hmd-Latn = hmd-Latn-CN
hmj-Bopo = hmj-Bopo-CN
hmn-Hmng = hmn-Hmng
hmn-Latn = hmn-Latn
hmq-Bopo = hmq-Bopo-CN
hmr-Latn = hmr-Latn-IN
hms-Latn = hms-Latn-CN
hmt = hmt-PG = *hmt-Latn = hmt-Latn-PG
hmz-Latn = hmz-Latn-CN
hmz-Plrd = hmz-Plrd-CN
hnd = hnd-PK = hnd-Arab = hnd-Arab-PK
hne = hne-IN = hne-Deva = hne-Deva-IN
hni-Latn = hni-Latn-CN
hnj = hnj-LA = hnj-Hmng = hnj-Hmng-LA
hnj-Latn = hnj-Latn-LA
hnj-Plrd = hnj-Plrd-CN
hnj-Thai = hnj-Thai-TH
hnn = hnn-PH = hnn-Latn = hnn-Latn-PH
hnn-Hano = hnn-Hano-PH
hno = hno-PK = *hno-Arab = hno-Arab-PK
hns-Latn = hns-Latn-SR
ho = ho-PG = ho-Latn = ho-Latn-PG
ho-Brai = ho-Brai-PG
hoc = hoc-IN = hoc-Deva = hoc-Deva-IN
hoc-Latn = hoc-Latn-IN
hoc-Orya = hoc-Orya-IN
hoc-Telu = hoc-Telu-IN
hoc-Wara = hoc-Wara-IN
hoj = hoj-IN = hoj-Deva = hoj-Deva-IN
hol-Latn = hol-Latn-AO
hoo-Latn = hoo-Latn-CD
hop-Latn = hop-Latn-US
hot = hot-PG = *hot-Latn = hot-Latn-PG
how-Hani = how-Hani-CN
*hr = *hr-HR = hr-Latn = hr-Latn-HR
*hr = hr-Latn
hr-Brai = hr-Brai-HR
hra-Latn = hra-Latn-IN
hrc = hrc-PG = hrc-Latn = hrc-Latn-PG
hre-Latn = hre-Latn-VN
hro-Latn = hro-Latn-VN
hrt-Syrc = hrt-Syrc-TR
hru-Latn = hru-Latn-IN
hrw = hrw-PG = hrw-Latn = hrw-Latn-PG
hrx = hrx-BR = hrx-Latn = hrx-Latn-BR
hrz-Arab = hrz-Arab-IR
*hsb = *hsb-DE = hsb-Latn = hsb-Latn-DE
*hsb = hsb-Latn
hsn = hsn-CN = hsn-Hans = hsn-Hans-CN
hsn-Hant = hsn-Hant-CN
hsn-Nshu = hsn-Nshu-CN
ht = ht-HT = ht-Latn = ht-Latn-HT
ht = ht-HT = ht-Latn = ht-Latn-HT
hto = hto-CO = hto-Latn = hto-Latn-CO
*hu = *hu-HU = hu-Latn = hu-Latn-HU
*hu = hu-Latn
hu-Brai = hu-Brai-HU
hu-Hung = hu-Hung-HU
hub = hub-PE = hub-Latn = hub-Latn-PE
hue = hue-MX = hue-Latn = hue-Latn-MX
hui = hui-PG = *hui-Latn = hui-Latn-PG
hul = hul-PG = hul-Latn = hul-Latn-PG
hum-Latn = hum-Latn-CD
hus = hus-MX = hus-Latn = hus-Latn-MX
huu = huu-PE = huu-Latn = huu-Latn-PE
huv = huv-MX = huv-Latn = huv-Latn-MX
hux = hux-PE = hux-Latn = hux-Latn-PE
huy-Hebr = huy-Hebr-IL
hve = hve-MX = hve-Latn = hve-Latn-MX
hvn-Latn = hvn-Latn-ID
hwc-Latn = hwc-Latn-US
hwo-Latn = hwo-Latn-NG
*hy = *hy-AM = hy-Armn = hy-Armn-AM
*hy = hy-Armn
hy-Brai = hy-Brai-AM
hz = hz-NA = hz-Latn = hz-Latn-NA
*ia = *ia-FR = ia-Latn = ia-Latn-FR
ia-SE = ia-Latn-SE
iai = iai-NC = iai-Latn = iai-Latn-NC
ian = ian-PG = *ian-Latn = ian-Latn-PG
iar = iar-PG = *iar-Latn = iar-Latn-PG
iba = iba-MY = iba-Latn = iba-Latn-MY
ibb = ibb-NG = ibb-Latn = ibb-Latn-NG
ibd = ibd-AU = ibd-Latn = ibd-Latn-AU
ibg-Latn = ibg-Latn-PH
ibl-Latn = ibl-Latn-PH
*iby-Latn = iby-Latn-NG
ica-Latn = ica-Latn-BJ
*ich-Latn = ich-Latn-NG
icr = icr-CO = icr-Latn = icr-Latn-CO
*id = *id-ID = id-Latn = id-Latn-ID
*id = id-Latn
id-Brai = id-Brai-ID
ida = ida-KE = ida-Latn = ida-Latn-KE
idb-Latn = idb-Latn-IN
idd-Latn = idd-Latn-BJ
idi = idi-PG = *idi-Latn = idi-Latn-PG
idt-Latn = idt-Latn-TL
*idu-Latn = idu-Latn-NG
ie-Latn = ie-Latn-??
ifa-Latn = ifa-Latn-PH
ifb-Latn = ifb-Latn-PH
*ife-Latn = ife-Latn-TG
ifk-Latn = ifk-Latn-PH
ifm-Latn = ifm-Latn-CG
ifu-Latn = ifu-Latn-PH
ify-Latn = ify-Latn-PH
*ig = *ig-NG = ig-Latn = ig-Latn-NG
*igb-Latn = igb-Latn-NG
*ige-Latn = ige-Latn-NG
igl-Latn = igl-Latn-NG
ign = ign-BO = ign-Latn = ign-Latn-BO
*ii = *ii-CN = ii-Yiii = ii-Yiii-CN
ii-Latn = ii-Latn-CN
ijc-Latn = ijc-Latn-NG
ijj-Latn = ijj-Latn-BJ
ijn-Latn = ijn-Latn-NG
ijs-Latn = ijs-Latn-NG
ik = ik-US = ik-Latn = ik-Latn-US
ike-Cans = ike-Cans-CA
*ikk-Latn = ikk-Latn-NG
ikt = ikt-CA = ikt-Latn = ikt-Latn-CA
ikt-Cans = ikt-Cans-CA
*ikw-Latn = ikw-Latn-NG
ikx = ikx-UG = *ikx-Latn = ikx-Latn-UG
ikz = ikz-TZ = ikz-Latn = ikz-Latn-TZ
ilb = ilb-ZM = ilb-Latn = ilb-Latn-ZM
ilk-Latn = ilk-Latn-PH
ilm-Latn = ilm-Latn-MY
ilo = ilo-PH = ilo-Latn = ilo-Latn-PH
ilo-Brai = ilo-Brai-PH
ilo-Tglg = ilo-Tglg-PH
ilp-Latn = ilp-Latn-PH
imo = imo-PG = *imo-Latn = imo-Latn-PG
in = in-ID = in-Latn = in-Latn-ID
in = in-Latn
inb = inb-CO = inb-Latn = inb-Latn-CO
ing-Latn = ing-Latn-US
inh = inh-RU = inh-Cyrl = inh-Cyrl-RU
inh-Arab = inh-Arab-RU
inh-Latn = inh-Latn-RU
inj = inj-CO = inj-Latn = inj-Latn-CO
ino = ino-PG = ino-Latn = ino-Latn-PG
inp = inp-PE = inp-Latn = inp-Latn-PE
io-Latn = io-Latn-??
iou = iou-PG = *iou-Latn = iou-Latn-PG
ipi = ipi-PG = ipi-Latn = ipi-Latn-PG
ipo = ipo-PG = ipo-Latn = ipo-Latn-PG
iqu = iqu-PE = iqu-Latn = iqu-Latn-PE
iqw-Latn = iqw-Latn-NG
irh-Latn = irh-Latn-ID
*iri-Latn = iri-Latn-NG
irk = irk-TZ = irk-Latn = irk-Latn-TZ
iru-Mlym = iru-Mlym-IN
iru-Taml = iru-Taml-IN
iry-Latn = iry-Latn-PH
*is = *is-IS = is-Latn = is-Latn-IS
*is = *is-IS = is-Latn = is-Latn-IS
isd-Latn = isd-Latn-PH
ish-Latn = ish-Latn-NG
isi-Latn = isi-Latn-NG
iso-Latn = iso-Latn-NG
isu-Latn = isu-Latn-CM
*it = *it-IT = it-Latn = it-Latn-IT
*it = it-Latn
it-Brai = it-Brai-IT
*it-SM = it-Latn-SM
it-VA = it-Latn-VA
itb-Latn = itb-Latn-PH
ite = ite-BO = ite-Latn = ite-Latn-BO
itk-Hebr = itk-Hebr-IT
itl-Cyrl = itl-Cyrl-RU
ito = ito-BO = ito-Latn = ito-Latn-BO
itr = itr-PG = itr-Latn = itr-Latn-PG
its-Latn = its-Latn-NG
itv-Latn = itv-Latn-PH
itw-Latn = itw-Latn-NG
itz = itz-GT = itz-Latn = itz-Latn-GT
*iu = iu-CA = iu-Cans = iu-Cans-CA
iu-Latn = iu-Latn-CA
ium-Hani = ium-Hani-CN
ium-Laoo = ium-Laoo-LA
ium-Latn = ium-Latn-CN
ium-Thai = ium-Thai-TH
ivb-Latn = ivb-Latn-PH
ivv-Latn = ivv-Latn-PH
iw = iw-Hebr
iw = iw-IL = iw-Hebr = iw-Hebr-IL
iwm = iwm-PG = *iwm-Latn = iwm-Latn-PG
iws = iws-PG = *iws-Latn = iws-Latn-PG
ixc = ixc-MX = ixc-Latn = ixc-Latn-MX
ixl = ixl-GT = ixl-Latn = ixl-Latn-GT
iyo-Latn = iyo-Latn-CM
iyx-Latn = iyx-Latn-CG
izh = izh-RU = izh-Latn = izh-Latn-RU
*izr-Latn = izr-Latn-NG
*izz-Latn = izz-Latn-NG
*ja = *ja-JP = ja-Jpan = ja-Jpan-JP
*ja = ja-Jpan
ja-Brai = ja-Brai-JP
ja-Hira = ja-Hira-JP
ja-Kana = ja-Kana-JP
jaa = jaa-BR = jaa-Latn = jaa-Latn-BR
*jab-Latn = jab-Latn-NG
jac = jac-GT = jac-Latn = jac-Latn-GT
jad-Arab = jad-Arab-GN
jae = jae-PG = jae-Latn = jae-Latn-PG
jah-Latn = jah-Latn-MY
jal-Latn = jal-Latn-ID
jam = jam-JM = jam-Latn = jam-Latn-JM
jao = jao-AU = jao-Latn = jao-Latn-AU
jax-Latn = jax-Latn-ID
jbe-Hebr = jbe-Hebr-IL
jbn-Arab = jbn-Arab-LY
*jbu-Latn = jbu-Latn-CM
jct-Cyrl = jct-Cyrl-UA
jct-Latn = jct-Latn-UA
jdg-Arab = jdg-Arab-PK
jdt = jdt-RU = jdt-Cyrl = jdt-Cyrl-RU
jdt-Hebr = jdt-Hebr-RU
jdt-Latn = jdt-Latn-AZ
jeb = jeb-PE = jeb-Latn = jeb-Latn-PE
jee-Deva = jee-Deva-NP
jeh-Laoo = jeh-Laoo-LA
jeh-Latn = jeh-Latn-VN
*jen-Latn = jen-Latn-NG
*jgk-Latn = jgk-Latn-NG
*jgo = *jgo-CM = jgo-Latn = jgo-Latn-CM
ji = ji-UA = ji-Hebr = ji-Hebr-UA
*jib-Latn = jib-Latn-NG
jic = jic-HN = jic-Latn = jic-Latn-HN
jim-Latn = jim-Latn-CM
jit = jit-TZ = jit-Latn = jit-Latn-TZ
jiu-Latn = jiu-Latn-CN
jiv = jiv-EC = jiv-Latn = jiv-Latn-EC
jiy-Latn = jiy-Latn-CN
jje-Hang = jje-Hang-KR
jko = jko-PG = jko-Latn = jko-Latn-PG
*jmc = *jmc-TZ = jmc-Latn = jmc-Latn-TZ
jmd-Latn = jmd-Latn-ID
jml = jml-NP = jml-Deva = jml-Deva-NP
jmn-Latn = jmn-Latn-MM
jmx = jmx-MX = jmx-Latn = jmx-Latn-MX
jnj-Latn = jnj-Latn-ET
jnl-Deva = jnl-Deva-IN
jns-Deva = jns-Deva-IN
jns-Latn = jns-Latn-IN
jns-Takr = jns-Takr-IN
jow-Latn = jow-Latn-ML
jpr-Hebr = jpr-Hebr-IL
jqr = jqr-PE = jqr-Latn = jqr-Latn-PE
*jra-Latn = jra-Latn-VN
jrb-Hebr = jrb-Hebr-IL
jua = jua-BR = jua-Latn = jua-Latn-BR
juk-Latn = juk-Latn-NG
jul-Deva = jul-Deva-NP
jum-Latn = jum-Latn-SD
jun-Orya = jun-Orya-IN
juo-Latn = juo-Latn-NG
jup = jup-BR = jup-Latn = jup-Latn-BR
jut = jut-DK = jut-Latn = jut-Latn-DK
jv = jv-ID = jv-Latn = jv-Latn-ID
jv-Java = jv-Java-ID
jvn = jvn-SR = jvn-Latn = jvn-Latn-SR
jw = jw-ID = jw-Latn = jw-Latn-ID
jya-Tibt = jya-Tibt-CN
jye-Hebr = jye-Hebr-IL
*ka = *ka-GE = ka-Geor = ka-Geor-GE
*ka = ka-Geor
ka-Brai = ka-Brai-GE
ka-Geok = ka-Geok-GE
kaa = kaa-UZ = kaa-Cyrl = kaa-Cyrl-UZ
kaa-Latn = kaa-Latn-UZ
*kab = *kab-DZ = kab-Latn = kab-Latn-DZ
kab-Tfng = kab-Tfng-DZ
kac = kac-MM = kac-Latn = kac-Latn-MM
*kad-Latn = kad-Latn-NG
*kai-Latn = kai-Latn-NG
kaj = kaj-NG = *kaj-Latn = kaj-Latn-NG
kak-Latn = kak-Latn-PH
*kam = *kam-KE = kam-Latn = kam-Latn-KE
kao = kao-ML = kao-Latn = kao-Latn-ML
kap-Cyrl = kap-Cyrl-RU
kaq = kaq-PE = kaq-Latn = kaq-Latn-PE
kaw-Bali = kaw-Bali-MY
kay = kay-BR = kay-Latn = kay-Latn-BR
kbc = kbc-BR = kbc-Latn = kbc-Latn-BR
kbd = kbd-RU = kbd-Cyrl = kbd-Cyrl-RU
kbd-TR = kbd-Cyrl-TR
kbg-Tibt-x-hingna = kbg-Tibt-IN-x-hingna
kbh = kbh-CO = kbh-Latn = kbh-Latn-CO
kbl-Latn = kbl-Latn-TD
kbm = kbm-PG = *kbm-Latn = kbm-Latn-PG
kbn-Latn = kbn-Latn-CF
kbo-Latn = kbo-Latn-SS
kbp-Brai = kbp-Brai-TG
*kbp-Latn = kbp-Latn-TG
kbq = kbq-PG = *kbq-Latn = kbq-Latn-PG
kbr-Ethi = kbr-Ethi-ET
kbr-Latn = kbr-Latn-ET
kbt = kbt-PG = kbt-Latn = kbt-Latn-PG
kbx = kbx-PG = *kbx-Latn = kbx-Latn-PG
*kby-Arab = kby-Arab-NE
*kby-Latn = kby-Latn-NE
kca-Cyrl = kca-Cyrl-RU
kcg = kcg-NG = *kcg-Latn = kcg-Latn-NG
kck = kck-ZW = kck-Latn = kck-Latn-ZW
kcl = kcl-PG = *kcl-Latn = kcl-Latn-PG
kcn = kcn-UG = kcn-Latn = kcn-Latn-UG
kcp-Latn = kcp-Latn-SD
kcq-Latn = kcq-Latn-NG
kct = kct-PG = kct-Latn = kct-Latn-PG
kdc = kdc-TZ = kdc-Latn = kdc-Latn-TZ
*kde = *kde-TZ = kde-Latn = kde-Latn-TZ
kdf = kdf-PG = kdf-Latn = kdf-Latn-PG
*kdh-Arab = kdh-Arab-TG
*kdh-Latn = kdh-Latn-TG
kdi = kdi-UG = kdi-Latn = kdi-Latn-UG
kdj = kdj-UG = kdj-Latn = kdj-Latn-UG
*kdl-Latn = kdl-Latn-NG
kdn = kdn-ZW = kdn-Latn = kdn-Latn-ZW
kdq-Beng = kdq-Beng-IN
kdr-Cyrl = kdr-Cyrl-UA
kdr-Latn = kdr-Latn-LT
kdt = kdt-TH = kdt-Thai = kdt-Thai-TH
kdt-KH = kdt-Thai-KH
kdt-Khmr = kdt-Khmr-KH
kdt-LA = kdt-Thai-LA
kdt-Laoo = kdt-Laoo-LA
*kea = *kea-CV = kea-Latn = kea-Latn-CV
keb-Latn = keb-Latn-GA
kec-Latn = kec-Latn-SD
ked = ked-TZ = ked-Latn = ked-Latn-TZ
kee-Latn = kee-Latn-US
keg-Latn = keg-Latn-SD
keh = keh-PG = keh-Latn = keh-Latn-PG
kei-Latn = kei-Latn-ID
kek = kek-GT = kek-Latn = kek-Latn-GT
kel-Latn = kel-Latn-CD
kem-Latn = kem-Latn-TL
ken = ken-CM = *ken-Latn = ken-Latn-CM
keo = keo-UG = keo-Latn = keo-Latn-UG
ker-Latn = ker-Latn-TD
ket-Cyrl = ket-Cyrl-RU
keu-Latn = keu-Latn-TG
kew = kew-PG = kew-Latn = kew-Latn-PG
kex-Deva = kex-Deva-IN
kex-Gujr = kex-Gujr-IN
key-Telu = key-Telu-IN
*kez-Latn = kez-Latn-NG
kfa-Knda = kfa-Knda-IN
kfb-Deva = kfb-Deva-IN
kfc-Telu = kfc-Telu-IN
kfe-Taml = kfe-Taml-IN
kff-Deva = kff-Deva-IN
kff-Latn = kff-Latn-IN
kff-Orya = kff-Orya-IN
kff-Telu = kff-Telu-IN
kfg-Knda = kfg-Knda-IN
kfg-Mlym = kfg-Mlym-IN
kfh-Mlym = kfh-Mlym-IN
kfi-Taml = kfi-Taml-IN
kfk-Deva = kfk-Deva-IN
kfk-Takr = kfk-Takr-IN
kfm-Arab = kfm-Arab-IR
kfo = kfo-CI = kfo-Latn = kfo-Latn-CI
kfq-Deva = kfq-Deva-IN
kfr = kfr-IN = kfr-Deva = kfr-Deva-IN
kfr-Gujr = kfr-Gujr-IN
kfv-Latn = kfv-Latn-IN
kfw-Latn = kfw-Latn-IN
kfx-Deva = kfx-Deva-IN
kfx-Takr = kfx-Takr-IN
kfy = kfy-IN = kfy-Deva = kfy-Deva-IN
kfz-Latn = kfz-Latn-BF
kg = kg-CD = kg-Latn = kg-Latn-CD
kgd-Laoo = kgd-Laoo-LA
kgd-Thai = kgd-Thai-LA
kge = kge-ID = kge-Latn = kge-Latn-ID
kgf = kgf-PG = *kgf-Latn = kgf-Latn-PG
kgj-Deva = kgj-Deva-NP
kgk = kgk-BR = kgk-Latn = kgk-Latn-BR
kgo-Latn = kgo-Latn-SD
kgp = kgp-BR = kgp-Latn = kgp-Latn-BR
kgr-Latn = kgr-Latn-ID
kha = kha-IN = kha-Latn = kha-Latn-IN
kha-Beng = kha-Beng-IN
khb = khb-CN = *khb-Talu = khb-Talu-CN
khb-Lana = khb-Lana-CN
khe-Latn = khe-Latn-ID
khf-Thai = khf-Thai-LA
khg-Tibt = khg-Tibt-CN
khk-Brai = khk-Brai-MN
khk-Cyrl = khk-Cyrl-MN
khk-Mong = khk-Mong-MN
khk-Phag = khk-Phag-MN
khk-Tibt = khk-Tibt-CN
khl = khl-PG = khl-Latn = khl-Latn-PG
khn = khn-IN = khn-Deva = khn-Deva-IN
*khq = *khq-ML = khq-Latn = khq-Latn-ML
khr-Deva = khr-Deva-IN
khr-Latn = khr-Latn-IN
khs = khs-PG = *khs-Latn = khs-Latn-PG
kht = kht-IN = kht-Mymr = kht-Mymr-IN
khu-Latn = khu-Latn-AO
khw = khw-PK = *khw-Arab = khw-Arab-PK
khy-Latn = khy-Latn-CD
khz = khz-PG = *khz-Latn = khz-Latn-PG
*ki = *ki-KE = ki-Latn = ki-Latn-KE
kia-Latn = kia-Latn-TD
kib-Latn = kib-Latn-SD
kic = kic-US = kic-Latn = kic-Latn-US
kih = kih-PG = kih-Latn = kih-Latn-PG
kij = kij-PG = *kij-Latn = kij-Latn-PG
kio-Latn = kio-Latn-US
kip-Deva = kip-Deva-NP
kit = kit-PG = kit-Latn = kit-Latn-PG
kiu = kiu-TR = kiu-Latn = kiu-Latn-TR
kiw = kiw-PG = *kiw-Latn = kiw-Latn-PG
kix-Latn = kix-Latn-IN
kj = kj-NA = kj-Latn = kj-Latn-NA
kj-Brai = kj-Brai-AO
kjb = kjb-GT = kjb-Latn = kjb-Latn-GT
kjc-Latn = kjc-Latn-ID
kjd = kjd-PG = *kjd-Latn = kjd-Latn-PG
kje-Latn = kje-Latn-ID
kjg = kjg-LA = kjg-Laoo = kjg-Laoo-LA
kjg-Latn = kjg-Latn-LA
kjh-Cyrl = kjh-Cyrl-RU
kji = kji-SB = kji-Latn = kji-Latn-SB
kjl-Deva = kjl-Deva-NP
kjn = kjn-AU = kjn-Latn = kjn-Latn-AU
kjp = kjp-MM = kjp-Mymr = kjp-Mymr-MM
kjp-Leke = kjp-Leke-MM
kjp-Thai = kjp-Thai-TH
kjq-Latn = kjq-Latn-US
kjs = kjs-PG = *kjs-Latn = kjs-Latn-PG
kjt-Thai = kjt-Thai-TH
kjv-Latn = kjv-Latn-??
kjx = kjx-PG = kjx-Latn = kjx-Latn-PG
kjy = kjy-PG = *kjy-Latn = kjy-Latn-PG
kjz-Tibt-x-uchen = kjz-Tibt-BT-x-uchen
*kk = kk-CN = *kk-Arab = kk-Arab-CN
*kk = *kk-Cyrl
*kk = *kk-KZ = *kk-Cyrl = *kk-Cyrl-KZ
kk-AF = kk-Arab-AF
kk-Brai = kk-Brai-KZ
kk-IR = kk-Arab-IR
kk-MN = kk-Arab-MN
kkc = kkc-PG = *kkc-Latn = kkc-Latn-PG
kkh-Lana = kkh-Lana-MM
kki = kki-TZ = kki-Latn = kki-Latn-TZ
*kkj = *kkj-CM = kkj-Latn = kkj-Latn-CM
kkl-Latn = kkl-Latn-ID
kko-Latn = kko-Latn-SD
kkt-Deva = kkt-Deva-NP
kkv-Latn = kkv-Latn-ID
kkw-Latn = kkw-Latn-CG
kky = kky-AU = kky-Latn = kky-Latn-AU
kkz-Latn = kkz-Latn-CA
*kl = *kl-GL = kl-Latn = kl-Latn-GL
*kl = kl-Latn
klc-Latn = klc-Latn-CM
kle-Deva = kle-Deva-NP
klg-Latn = klg-Latn-PH
kli-Latn = kli-Latn-ID
kll-Latn = kll-Latn-PH
*kln = *kln-KE = kln-Latn = kln-Latn-KE
klq = klq-PG = *klq-Latn = klq-Latn-PG
klr-Deva = klr-Deva-NP
kls-Arab = kls-Arab-PK
kls-Latn = kls-Latn-PK
klt = klt-PG = *klt-Latn = klt-Latn-PG
klu-Latn = klu-Latn-LR
klv = klv-VU = klv-Latn = klv-Latn-VU
klw-Latn = klw-Latn-ID
klx = klx-PG = *klx-Latn = klx-Latn-PG
*km = *km-KH = km-Khmr = km-Khmr-KH
*km = *km-KH = km-Khmr = km-Khmr-KH
kma-Latn = kma-Latn-GH
kmb = kmb-AO = kmb-Latn = kmb-Latn-AO
kmc-Hani = kmc-Hani-CN
kmc-Latn = kmc-Latn-CN
kmd-Latn = kmd-Latn-PH
kmf = kmf-PG = kmf-Latn = kmf-Latn-PG
kmg = kmg-PG = kmg-Latn = kmg-Latn-PG
kmh = kmh-PG = *kmh-Latn = kmh-Latn-PG
kmk-Latn = kmk-Latn-PH
kml-Latn = kml-Latn-PH
kmm-Latn = kmm-Latn-IN
kmo = kmo-PG = *kmo-Latn = kmo-Latn-PG
kmp-Latn = kmp-Latn-CM
kmq-Latn = kmq-Latn-ET
*kmr-Arab = kmr-Arab-TR
kmr-Cyrl = kmr-Cyrl-TR
kmr-Latn = kmr-Latn-TR
kms = kms-PG = *kms-Latn = kms-Latn-PG
kmt-Latn = kmt-Latn-ID
kmu = kmu-PG = *kmu-Latn = kmu-Latn-PG
kmv = kmv-BR = kmv-Latn = kmv-Latn-BR
*kmw-Latn = kmw-Latn-CD
kmx = kmx-PG = kmx-Latn = kmx-Latn-PG
kmy-Latn = kmy-Latn-NG
kmz-Arab = kmz-Arab-IR
*kn = *kn-IN = kn-Knda = kn-Knda-IN
*kn = *kn-IN = kn-Knda = kn-Knda-IN
kn-Brai = kn-Brai-IN
kna-Latn = kna-Latn-NG
knb-Latn = knb-Latn-PH
*knc-Arab = knc-Arab-NG
*knc-Latn = knc-Latn-NG
kne-Latn = kne-Latn-PH
*knf-Latn = knf-Latn-GW
kng-Latn = kng-Latn-CD
knj = knj-GT = knj-Latn = knj-Latn-GT
knk-Latn = knk-Latn-SL
knn = knn-IN = knn-Deva = knn-Deva-IN
knn-Knda = knn-Knda-IN
knn-Latn = knn-Latn-IN
kno-Latn = kno-Latn-SL
*knp-Latn = knp-Latn-CM
kns-Latn = kns-Latn-MY
kns-Thai = kns-Thai-TH
knv = knv-PG = knv-Latn = knv-Latn-PG
knw-Latn = knw-Latn-NA
knx-Latn = knx-Latn-ID
kny-Latn = kny-Latn-CD
knz-Latn = knz-Latn-BF
*ko = *ko-KR = ko-Kore = ko-Kore-KR
*ko = ko-Kore
ko-Brai = ko-Brai-KR
ko-Hang = ko-Hang-KR
*ko-KP = ko-Kore-KP
ko-Latn = ko-Latn-KR
koe-Latn = koe-Latn-SS
kog = kog-CO = kog-Latn = kog-Latn-CO
koi = koi-RU = koi-Cyrl = koi-Cyrl-RU
koi-Latn = koi-Latn-RU
koi-Perm = koi-Perm-RU
*kok = *kok-IN = kok-Deva = kok-Deva-IN
*kok = *kok-IN = kok-Deva = kok-Deva-IN
kol = kol-PG = *kol-Latn = kol-Latn-PG
koo = koo-UG = koo-Latn = koo-Latn-UG
koq-Latn = koq-Latn-GA
kos = kos-FM = kos-Latn = kos-Latn-FM
kot-Latn = kot-Latn-CM
koy-Latn = koy-Latn-US
kpc = kpc-CO = kpc-Latn = kpc-Latn-CO
*kpe = kpe-LR = kpe-Latn = kpe-Latn-LR
kpf = kpf-PG = *kpf-Latn = kpf-Latn-PG
kpg-Latn = kpg-Latn-FM
kpj = kpj-BR = kpj-Latn = kpj-Latn-BR
kpm-Latn = kpm-Latn-VN
*kpo-Latn = kpo-Latn-TG
kpq-Latn = kpq-Latn-ID
kpr = kpr-PG = *kpr-Latn = kpr-Latn-PG
kps-Latn = kps-Latn-ID
kpv-Cyrl = kpv-Cyrl-RU
kpw = kpw-PG = *kpw-Latn = kpw-Latn-PG
kpx = kpx-PG = *kpx-Latn = kpx-Latn-PG
kpy-Cyrl = kpy-Cyrl-RU
kpz = kpz-UG = kpz-Latn = kpz-Latn-UG
kqa = kqa-PG = kqa-Latn = kqa-Latn-PG
kqb = kqb-PG = *kqb-Latn = kqb-Latn-PG
kqc = kqc-PG = kqc-Latn = kqc-Latn-PG
kqd-Syrc = kqd-Syrc-IQ
kqe-Latn = kqe-Latn-PH
kqf = kqf-PG = *kqf-Latn = kqf-Latn-PG
kql = kql-PG = kql-Latn = kql-Latn-PG
kqn = kqn-ZM = kqn-Latn = kqn-Latn-ZM
kqo-Latn = kqo-Latn-LR
kqp-Latn = kqp-Latn-TD
kqr-Latn = kqr-Latn-MY
*kqs-Latn = kqs-Latn-GN
kqw = kqw-PG = kqw-Latn = kqw-Latn-PG
kqx-Latn = kqx-Latn-CM
kqy = kqy-ET = kqy-Latn = kqy-Latn-ET
*kqy-Ethi = kqy-Ethi-ET
kqz = kqz-ZA = kqz-Latn = kqz-Latn-ZA
kr-Latn = kr-Latn-NG
kra-Deva = kra-Deva-NP
krc = krc-RU = krc-Cyrl = krc-Cyrl-RU
krd-Latn = krd-Latn-TL
kre = kre-BR = kre-Latn = kre-Latn-BR
krf = krf-VU = krf-Latn = krf-Latn-VU
kri = kri-SL = *kri-Latn = kri-Latn-SL
krj = krj-PH = krj-Latn = krj-Latn-PH
krl = krl-RU = krl-Latn = krl-Latn-RU
krl-Cyrl = krl-Cyrl-RU
krn-Latn = krn-Latn-LR
krr-Khmr = krr-Khmr-KH
*krs-Latn = krs-Latn-SS
krt-Latn = krt-Latn-NE
kru = kru-IN = kru-Deva = kru-Deva-IN
krv-Khmr = krv-Khmr-KH
krw-Latn = krw-Latn-LR
krx-Latn = krx-Latn-SN
*ks = *ks-IN = *ks-Arab = *ks-Arab-IN
ks-Deva = ks-Deva-IN
ks-GB = ks-Arab-GB
ks-Latn = ks-Latn-IN
ks-Shrd = ks-Shrd-IN
*ksb = *ksb-TZ = ksb-Latn = ksb-Latn-TZ
ksc-Latn = ksc-Latn-PH
ksd = ksd-PG = *ksd-Latn = ksd-Latn-PG
kse = kse-PG = kse-Latn = kse-Latn-PG
*ksf = *ksf-CM = ksf-Latn = ksf-Latn-CM
*ksh = *ksh-DE = ksh-Latn = ksh-Latn-DE
ksj = ksj-PG = ksj-Latn = ksj-Latn-PG
ksl = ksl-PG = ksl-Latn = ksl-Latn-PG
ksp-Latn = ksp-Latn-CF
ksr = ksr-PG = *ksr-Latn = ksr-Latn-PG
kss-Latn = kss-Latn-LR
kst-Latn = kst-Latn-BF
ksw-Latn = ksw-Latn-MM
ksw-Mymr = ksw-Mymr-MM
ksz-Deva = ksz-Deva-IN
*ktb-Ethi = ktb-Ethi-ET
ktb-Latn = ktb-Latn-ET
ktj-Latn = ktj-Latn-CI
ktm = ktm-PG = *ktm-Latn = ktm-Latn-PG
ktn = ktn-BR = ktn-Latn = ktn-Latn-BR
kto = kto-PG = *kto-Latn = kto-Latn-PG
ktp-Plrd = ktp-Plrd-CN
ktu-Latn = ktu-Latn-CD
ktv-Latn = ktv-Latn-VN
ktz-Latn = ktz-Latn-NA
*ku = ku-TR = ku-Latn = ku-Latn-TR
ku-AM = ku-Latn-AM
*ku-Arab = ku-Arab-IQ
ku-Cyrl = ku-Cyrl-IQ
ku-GE = ku-Latn-GE
ku-LB = ku-Arab-LB
*kub-Latn = kub-Latn-NG
kud = kud-PG = *kud-Latn = kud-Latn-PG
kue = kue-PG = *kue-Latn = kue-Latn-PG
kuf-Laoo = kuf-Laoo-LA
kuf-Tale = kuf-Tale-LA
kuh-Latn = kuh-Latn-NG
kui = kui-BR = kui-Latn = kui-Latn-BR
kuj = kuj-TZ = *kuj-Latn = kuj-Latn-TZ
kum = kum-RU = kum-Cyrl = kum-Cyrl-RU
*kun-Latn = kun-Latn-ER
kup = kup-PG = *kup-Latn = kup-Latn-PG
*kus-Latn = kus-Latn-GH
kut-Latn = kut-Latn-CA
kuu-Latn = kuu-Latn-US
kv = kv-RU = kv-Cyrl = kv-Cyrl-RU
kv-Latn = kv-Latn-RU
kv-Perm = kv-Perm-RU
kvc = kvc-PG = kvc-Latn = kvc-Latn-PG
kvg = kvg-PG = *kvg-Latn = kvg-Latn-PG
kvj-Latn = kvj-Latn-CM
kvl-Latn = kvl-Latn-MM
kvn = kvn-CO = kvn-Latn = kvn-Latn-CO
kvo-Latn = kvo-Latn-ID
kvq-Latn = kvq-Latn-MM
kvq-Mymr = kvq-Mymr-MM
kvr = kvr-ID = kvr-Latn = kvr-Latn-ID
kvr-Rjng = kvr-Rjng-ID
kvv-Latn = kvv-Latn-ID
kvx = kvx-PK = *kvx-Arab = kvx-Arab-PK
*kw = *kw-GB = kw-Latn = kw-Latn-GB
kwd = kwd-SB = kwd-Latn = kwd-Latn-SB
kwe-Latn = kwe-Latn-ID
kwf = kwf-SB = kwf-Latn = kwf-Latn-SB
kwg-Latn = kwg-Latn-TD
kwh-Latn = kwh-Latn-ID
kwi = kwi-CO = kwi-Latn = kwi-Latn-CO
kwj = kwj-PG = *kwj-Latn = kwj-Latn-PG
kwk-Latn = kwk-Latn-CA
kwm-Latn = kwm-Latn-NA
kwn-Latn = kwn-Latn-NA
kwo = kwo-PG = *kwo-Latn = kwo-Latn-PG
kws-Latn = kws-Latn-CD
kwv-Latn = kwv-Latn-TD
kwy-Latn = kwy-Latn-CD
kxa = kxa-PG = kxa-Latn = kxa-Latn-PG
*kxc-Ethi = kxc-Ethi-ET
kxc-Latn = kxc-Latn-ET
kxd-Arab = kxd-Arab-BN
kxd-Latn = kxd-Latn-BN
kxf-Latn = kxf-Latn-MM
kxf-Mymr = kxf-Mymr-MM
kxi-Latn = kxi-Latn-MY
kxl-Deva = kxl-Deva-NP
kxm = kxm-TH = kxm-Thai = kxm-Thai-TH
kxm-Khmr = kxm-Khmr-TH
kxp = kxp-PK = *kxp-Arab = kxp-Arab-PK
kxu-Orya = kxu-Orya-IN
kxv-Orya = kxv-Orya-IN
kxw = kxw-PG = *kxw-Latn = kxw-Latn-PG
kxx-Latn = kxx-Latn-CG
kxz = kxz-PG = *kxz-Latn = kxz-Latn-PG
*ky = ky-CN = *ky-Arab = ky-Arab-CN
*ky = *ky-KG = *ky-Cyrl = *ky-Cyrl-KG
*ky = ky-TR = ky-Latn = ky-Latn-TR
kya = kya-TZ = kya-Latn = kya-Latn-TZ
kyb-Latn = kyb-Latn-PH
kyc = kyc-PG = kyc-Latn = kyc-Latn-PG
*kye-Latn = kye-Latn-GH
kyf-Latn = kyf-Latn-CI
kyg = kyg-PG = kyg-Latn = kyg-Latn-PG
kyj-Latn = kyj-Latn-PH
kyq-Latn = kyq-Latn-TD
kys-Latn = kys-Latn-MY
kyu-Kali = kyu-Kali-MM
kyu-Latn = kyu-Latn-MM
kyu-Mymr = kyu-Mymr-MM
kyw-Beng = kyw-Beng-IN
kyw-Deva = kyw-Deva-IN
kyw-Orya = kyw-Orya-IN
kyx = kyx-PG = *kyx-Latn = kyx-Latn-PG
kyz = kyz-BR = kyz-Latn = kyz-Latn-BR
kzc-Latn = kzc-Latn-CI
kze = kze-PG = kze-Latn = kze-Latn-PG
kzf-Latn = kzf-Latn-ID
kzi-Latn = kzi-Latn-MY
*kzr-Latn = kzr-Latn-CM
la = la-VA = la-Latn = la-Latn-VA
la = la-VA = la-Latn = la-Latn-VA
laa-Latn = laa-Latn-PH
lab = lab-GR = lab-Lina = lab-Lina-GR
lac = lac-MX = lac-Latn = lac-Latn-MX
lad = lad-IL = lad-Hebr = lad-Hebr-IL
lad-Cyrl = lad-Cyrl-TR
lad-Latn = lad-Latn-TR
lae-Deva = lae-Deva-IN
lae-Tibt = lae-Tibt-IN
*lag = *lag-TZ = lag-Latn = lag-Latn-TZ
lah = lah-PK = lah-Arab = lah-Arab-PK
lai-Latn = lai-Latn-MW
laj = laj-UG = laj-Latn = laj-Latn-UG
lam = lam-ZM = lam-Latn = lam-Latn-ZM
lap-Latn = lap-Latn-TD
*las-Latn = las-Latn-TG
lax-Beng = lax-Beng-IN
lax-Latn = lax-Latn-IN
*lb = *lb-LU = lb-Latn = lb-Latn-LU
*lb = *lb-LU = lb-Latn = lb-Latn-LU
lbb = lbb-PG = lbb-Latn = lbb-Latn-PG
lbe = lbe-RU = lbe-Cyrl = lbe-Cyrl-RU
lbf-Deva = lbf-Deva-IN
lbf-Tibt = lbf-Tibt-CN
lbj-Tibt = lbj-Tibt-IN
lbk-Latn = lbk-Latn-PH
lbn-Laoo = lbn-Laoo-LA
lbn-Latn = lbn-Latn-LA
lbq = lbq-PG = lbq-Latn = lbq-Latn-PG
lbr-Deva = lbr-Deva-NP
lbw = lbw-ID = lbw-Latn = lbw-Latn-ID
lch-Latn = lch-Latn-AO
lcm = lcm-PG = *lcm-Latn = lcm-Latn-PG
lcp = lcp-CN = lcp-Thai = lcp-Thai-CN
*ldb-Latn = ldb-Latn-NG
ldi-Latn = ldi-Latn-CG
ldm-Latn = ldm-Latn-GN
lea-Latn = lea-Latn-CD
leb = leb-ZM = leb-Latn = leb-Latn-ZM
*led-Latn = led-Latn-CD
*lee-Latn = lee-Latn-BF
lef-Latn = lef-Latn-GH
leh = leh-ZM = leh-Latn = leh-Latn-ZM
*lem-Latn = lem-Latn-CM
lep = lep-IN = *lep-Lepc = lep-Lepc-IN
lep-Tibt = lep-Tibt-IN
leq = leq-PG = *leq-Latn = leq-Latn-PG
les-Latn = les-Latn-CD
leu = leu-PG = *leu-Latn = leu-Latn-PG
lew-Latn = lew-Latn-ID
lex-Latn = lex-Latn-ID
lez = lez-RU = lez-Cyrl = lez-Cyrl-RU
lez-Aghb = lez-Aghb-RU
lfn-Latn = lfn-Latn-??
*lg = *lg-UG = lg-Latn = lg-Latn-UG
lga = lga-SB = lga-Latn = lga-Latn-SB
lgg = lgg-UG = *lgg-Latn = lgg-Latn-UG
lgl = lgl-SB = lgl-Latn = lgl-Latn-SB
lgm-Latn = lgm-Latn-CD
lgn-Latn = lgn-Latn-ET
lgr = lgr-SB = lgr-Latn = lgr-Latn-SB
lhi-Latn = lhi-Latn-CN
lhm-Deva = lhm-Deva-NP
lht = lht-VU = lht-Latn = lht-Latn-VU
lhu-Latn = lhu-Latn-CN
li = li-NL = li-Latn = li-Latn-NL
*lia-Latn = lia-Latn-SL
lic-Latn = lic-Latn-CN
lid = lid-PG = *lid-Latn = lid-Latn-PG
lif = lif-NP = lif-Deva = lif-Deva-NP
*lif-Limb = lif-Limb-IN
lih = lih-PG = *lih-Latn = lih-Latn-PG
lij = lij-IT = lij-Latn = lij-Latn-IT
lik-Latn = lik-Latn-CD
lip-Latn = lip-Latn-GH
liq-Latn = liq-Latn-ET
lis = lis-CN = *lis-Lisu = lis-Lisu-CN
lis-Latn = lis-Latn-CN
liu-Latn = liu-Latn-SD
liv-Latn = liv-Latn-LV
liy-Latn = liy-Latn-CF
lje-Latn = lje-Latn-ID
ljp = ljp-ID = ljp-Latn = ljp-Latn-ID
ljp-Rjng = ljp-Rjng-ID
lka-Latn = lka-Latn-TL
lkb = lkb-KE = lkb-Latn = lkb-Latn-KE
lki = lki-IR = lki-Arab = lki-Arab-IR
lkn = lkn-VU = lkn-Latn = lkn-Latn-VU
lko = lko-KE = lko-Latn = lko-Latn-KE
lkr-Latn = lkr-Latn-SS
lks = lks-KE = lks-Latn = lks-Latn-KE
*lkt = *lkt-US = lkt-Latn = lkt-Latn-US
lla-Latn = lla-Latn-NG
llb-Latn = llb-Latn-MZ
llc-Latn = llc-Latn-GN
lld-Latn = lld-Latn-IT
lle = lle-PG = *lle-Latn = lle-Latn-PG
llg-Latn = llg-Latn-ID
lli-Latn = lli-Latn-CG
*lln-Latn = lln-Latn-TD
llp = llp-VU = llp-Latn = llp-Latn-VU
llu = llu-SB = llu-Latn = llu-Latn-SB
lmb = lmb-VU = lmb-Latn = lmb-Latn-VU
lmd-Latn = lmd-Latn-SD
lme-Latn = lme-Latn-TD
lmg = lmg-PG = lmg-Latn = lmg-Latn-PG
lmk-Latn = lmk-Latn-IN
lmk-Mymr = lmk-Mymr-IN
lml = lml-VU = lml-Latn = lml-Latn-VU
lmn = lmn-IN = lmn-Telu = lmn-Telu-IN
lmn-Deva = lmn-Deva-IN
lmn-Knda = lmn-Knda-IN
lmo = lmo-IT = lmo-Latn = lmo-Latn-IT
lmo-CH = lmo-Latn-CH
*lmp-Latn = lmp-Latn-CM
lmu = lmu-VU = lmu-Latn = lmu-Latn-VU
*ln = *ln-CD = ln-Latn = ln-Latn-CD
*ln = ln-Latn
lnd-Latn = lnd-Latn-ID
lnl-Latn = lnl-Latn-CF
*lns-Latn = lns-Latn-CM
*lnu-Latn = lnu-Latn-NG
*lo = *lo-LA = lo-Laoo = lo-Laoo-LA
*lo = *lo-LA = lo-Laoo = lo-Laoo-LA
loa-Latn = loa-Latn-ID
lob-Latn = lob-Latn-BF
loc-Latn = loc-Latn-PH
loe-Latn = loe-Latn-ID
log-Latn = log-Latn-CD
loh-Latn = loh-Latn-SS
loj = loj-PG = *loj-Latn = loj-Latn-PG
*lok-Latn = lok-Latn-SL
lol = lol-CD = lol-Latn = lol-Latn-CD
lom-Latn = lom-Latn-LR
lom-Loma = lom-Loma-LR
lon-Latn = lon-Latn-MW
loq-Latn = loq-Latn-CD
*lor-Latn = lor-Latn-CI
lot-Latn = lot-Latn-SS
*loy-Deva = loy-Deva-NP
loy-Tibt = loy-Tibt-NP
loz = loz-ZM = loz-Latn = loz-Latn-ZM
lpa = lpa-VU = lpa-Latn = lpa-Latn-VU
lpo-Lisu = lpo-Lisu-CN
*lpo-Plrd = lpo-Plrd-CN
lpx-Latn = lpx-Latn-SS
lra-Latn = lra-Latn-MY
*lrc = *lrc-IR = lrc-Arab = lrc-Arab-IR
lri = lri-KE = lri-Latn = lri-Latn-KE
lrl-Arab = lrl-Arab-IR
lrm = lrm-KE = lrm-Latn = lrm-Latn-KE
lro-Latn = lro-Latn-SD
lrt-Latn = lrt-Latn-ID
lsa-Arab = lsa-Arab-IR
lsd-Hebr = lsd-Hebr-IL
lse-Latn = lse-Latn-CD
lsi-Latn = lsi-Latn-MM
lsm = lsm-UG = lsm-Latn = lsm-Latn-UG
*lt = *lt-LT = lt-Latn = lt-Latn-LT
*lt = lt-Latn
lt-Latf = lt-Latf-LT
ltg = ltg-LV = ltg-Latn = ltg-Latn-LV
lto = lto-KE = lto-Latn = lto-Latn-KE
lts = lts-KE = lts-Latn = lts-Latn-KE
*lu = *lu-CD = lu-Latn = lu-Latn-CD
lua = lua-CD = lua-Latn = lua-Latn-CD
luc = luc-UG = luc-Latn = luc-Latn-UG
lud-Latn = lud-Latn-RU
lue = lue-ZM = lue-Latn = lue-Latn-ZM
lui-Latn = lui-Latn-US
luj-Latn = luj-Latn-CD
lul-Latn = lul-Latn-SS
lum-Latn = lum-Latn-AO
lun = lun-ZM = lun-Latn = lun-Latn-ZM
*luo = *luo-KE = luo-Latn = luo-Latn-KE
lup-Latn = lup-Latn-GA
lus-Beng = lus-Beng-IN
lus-Brai = lus-Brai-IN
lus-Latn = lus-Latn-IN
lut-Latn = lut-Latn-US
*luy = *luy-KE = luy-Latn = luy-Latn-KE
luz = luz-IR = luz-Arab = luz-Arab-IR
*lv = *lv-LV = lv-Latn = lv-Latn-LV
*lv = *lv-LV = lv-Latn = lv-Latn-LV
lv-Brai = lv-Brai-LV
lva-Latn = lva-Latn-TL
lvk = lvk-SB = lvk-Latn = lvk-Latn-SB
lvs-Latn = lvs-Latn-LV
lwg = lwg-KE = lwg-Latn = lwg-Latn-KE
lwl = lwl-TH = lwl-Thai = lwl-Thai-TH
lwm-Thai = lwm-Thai-CN
lwo-Latn = lwo-Latn-SS
lww = lww-VU = lww-Latn = lww-Latn-VU
lyn = lyn-ZM = lyn-Latn = lyn-Latn-ZM
lzh = lzh-CN = lzh-Hans = lzh-Hans-CN
lzh-Hant = lzh-Hant-CN
lzh-Phag = lzh-Phag-CN
lzn-Latn = lzn-Latn-MM
lzz = lzz-TR = lzz-Latn = lzz-Latn-TR
lzz-Geor = lzz-Geor-TR
maa = maa-MX = maa-Latn = maa-Latn-MX
mab = mab-MX = mab-Latn = mab-Latn-MX
mad = mad-ID = mad-Latn = mad-Latn-ID
maf = maf-CM = maf-Latn = maf-Latn-CM
mag = mag-IN = mag-Deva = mag-Deva-IN
mai = mai-Deva
mai = mai-IN = mai-Deva = mai-Deva-IN
mai-Kthi = mai-Kthi-IN
mai-Newa = mai-Newa-IN
mai-Tirh = mai-Tirh-IN
maj = maj-MX = maj-Latn = maj-Latn-MX
mak = mak-ID = mak-Latn = mak-Latn-ID
mak-Bugi = mak-Bugi-ID
mam = mam-GT = mam-Latn = mam-Latn-GT
man = man-GM = man-Latn = man-Latn-GM
man = man-GN = man-Nkoo = man-Nkoo-GN
maq = maq-MX = maq-Latn = maq-Latn-MX
*mas = *mas-KE = mas-Latn = mas-Latn-KE
mau = mau-MX = mau-Latn = mau-Latn-MX
mav = mav-BR = mav-Latn = mav-Latn-BR
*maw-Latn = maw-Latn-GH
max-Latn = max-Latn-ID
maz = maz-MX = maz-Latn = maz-Latn-MX
mba-Latn = mba-Latn-PH
mbb-Latn = mbb-Latn-PH
mbc = mbc-BR = mbc-Latn = mbc-Latn-BR
mbd-Latn = mbd-Latn-PH
mbf-Latn = mbf-Latn-SG
mbh = mbh-PG = *mbh-Latn = mbh-Latn-PG
mbi-Latn = mbi-Latn-PH
mbj = mbj-BR = mbj-Latn = mbj-Latn-BR
mbk = mbk-PG = mbk-Latn = mbk-Latn-PG
mbl = mbl-BR = mbl-Latn = mbl-Latn-BR
mbn = mbn-CO = mbn-Latn = mbn-Latn-CO
*mbo-Latn = mbo-Latn-CM
mbp = mbp-CO = mbp-Latn = mbp-Latn-CO
mbq = mbq-PG = *mbq-Latn = mbq-Latn-PG
mbs-Latn = mbs-Latn-PH
mbt-Latn = mbt-Latn-PH
*mbu-Latn = mbu-Latn-NG
mbw = mbw-PG = *mbw-Latn = mbw-Latn-PG
mbz = mbz-MX = mbz-Latn = mbz-Latn-MX
mca = mca-PY = mca-Latn = mca-Latn-PY
mcb = mcb-PE = mcb-Latn = mcb-Latn-PE
mcc = mcc-PG = mcc-Latn = mcc-Latn-PG
mcd = mcd-PE = mcd-Latn = mcd-Latn-PE
mcf = mcf-PE = mcf-Latn = mcf-Latn-PE
mch = mch-VE = mch-Latn = mch-Latn-VE
mci = mci-PG = *mci-Latn = mci-Latn-PG
mck-Latn = mck-Latn-AO
mcm-Latn = mcm-Latn-MY
mcn-Latn = mcn-Latn-TD
mco = mco-MX = mco-Latn = mco-Latn-MX
*mcp-Latn = mcp-Latn-CM
mcq = mcq-PG = *mcq-Latn = mcq-Latn-PG
mcr = mcr-PG = *mcr-Latn = mcr-Latn-PG
mcs-Latn = mcs-Latn-CM
mct-Latn = mct-Latn-CM
*mcu-Latn = mcu-Latn-CM
mcw-Latn = mcw-Latn-TD
mcx-Latn = mcx-Latn-CF
*mda-Latn = mda-Latn-NG
mdc = mdc-PG = mdc-Latn = mdc-Latn-PG
mdd-Latn = mdd-Latn-CM
*mde-Arab = mde-Arab-TD
mde-Latn = mde-Latn-TD
mdf = mdf-RU = mdf-Cyrl = mdf-Cyrl-RU
mdh = mdh-PH = mdh-Latn = mdh-Latn-PH
mdi-Latn = mdi-Latn-CD
*mdj-Latn = mdj-Latn-CD
mdm-Latn = mdm-Latn-CD
mdp-Latn = mdp-Latn-CD
mdr = mdr-ID = mdr-Latn = mdr-Latn-ID
mdr-Bugi = mdr-Bugi-ID
mdt = mdt-GA
mdv = mdv-MX = mdv-Latn = mdv-Latn-MX
mdw-Latn = mdw-Latn-CG
*mdx-Ethi = mdx-Ethi-ET
mdx-Latn = mdx-Latn-ET
mdy-Ethi = mdy-Ethi-ET
mdz = mdz-BR = mdz-Latn = mdz-Latn-BR
med = med-PG = *med-Latn = med-Latn-PG
mee = mee-PG = *mee-Latn = mee-Latn-PG
meh = meh-MX = meh-Latn = meh-Latn-MX
mej-Latn = mej-Latn-ID
mek = mek-PG = *mek-Latn = mek-Latn-PG
*men = men-Latn
*men = men-SL = men-Latn = men-Latn-SL
men-Mend = men-Mend-SL
meo-Latn = meo-Latn-MY
meq-Latn = meq-Latn-CM
*mer = *mer-KE = mer-Latn = mer-Latn-KE
met = met-PG = *met-Latn = met-Latn-PG
meu = meu-PG = *meu-Latn = meu-Latn-PG
mev-Latn = mev-Latn-LR
mey-Arab = mey-Arab-MR
mey-Latn = mey-Latn-MR
mez-Latn = mez-Latn-US
mfa = mfa-TH = mfa-Arab = mfa-Arab-TH
mfa-Thai = mfa-Thai-TH
*mfe = *mfe-MU = mfe-Latn = mfe-Latn-MU
mfg-Arab = mfg-Arab-GN
mfh-Latn = mfh-Latn-CM
mfi-Latn = mfi-Latn-CM
mfk-Latn = mfk-Latn-CM
mfm-Latn = mfm-Latn-NG
*mfn-Latn = mfn-Latn-NG
*mfo-Latn = mfo-Latn-NG
*mfq-Latn = mfq-Latn-TG
mfu-Latn = mfu-Latn-AO
mfv-Latn = mfv-Latn-GW
mfy = mfy-MX = mfy-Latn = mfy-Latn-MX
mfz-Latn = mfz-Latn-SS
*mg = *mg-MG = mg-Latn = mg-Latn-MG
*mg = *mg-MG = mg-Latn = mg-Latn-MG
mgc-Latn = mgc-Latn-SS
mgd-Latn = mgd-Latn-SS
mge-Latn = mge-Latn-TD
mgg-Latn = mgg-Latn-CM
*mgh = *mgh-MZ = mgh-Latn = mgh-Latn-MZ
mgi-Latn = mgi-Latn-NG
mgl = mgl-PG = *mgl-Latn = mgl-Latn-PG
mgm-Latn = mgm-Latn-TL
*mgo = *mgo-CM = mgo-Latn = mgo-Latn-CM
mgp = mgp-NP = mgp-Deva = mgp-Deva-NP
mgp-Qabl = mgp-Qabl-NP
mgq = mgq-TZ = mgq-Latn = mgq-Latn-TZ
mgr = mgr-ZM = mgr-Latn = mgr-Latn-ZM
mgs = mgs-TZ = mgs-Latn = mgs-Latn-TZ
mgu = mgu-PG = mgu-Latn = mgu-Latn-PG
mgy = mgy-TZ = mgy-Latn = mgy-Latn-TZ
mgy-ID = mgy-Latn-ID
mh = mh-MH = mh-Latn = mh-Latn-MH
mh = mh-MH = mh-Latn = mh-Latn-MH
mhi = mhi-UG = *mhi-Latn = mhi-Latn-UG
mhk-Latn = mhk-Latn-CM
mhl = mhl-PG = *mhl-Latn = mhl-Latn-PG
mhm-Latn = mhm-Latn-MZ
mho = mho-ZM = mho-Latn = mho-Latn-ZM
mhr-Cyrl = mhr-Cyrl-RU
mhr-Latn = mhr-Latn-RU
mhs-Latn = mhs-Latn-ID
mhw = mhw-BW = mhw-Latn = mhw-Latn-BW
mhx-Latn = mhx-Latn-MM
mhy-Latn = mhy-Latn-ID
*mi = mi-NZ = mi-Latn = mi-Latn-NZ
mib = mib-MX = mib-Latn = mib-Latn-MX
mic-Latn = mic-Latn-CA
mic-Qabg = mic-Qabg-CA
mid-Mand = mid-Mand-IQ
mie = mie-MX = mie-Latn = mie-Latn-MX
*mif-Latn = mif-Latn-CM
mig = mig-MX = mig-Latn = mig-Latn-MX
mih = mih-MX = mih-Latn = mih-Latn-MX
mii = mii-MX = mii-Latn = mii-Latn-MX
mik-Latn = mik-Latn-US
mil = mil-MX = mil-Latn = mil-Latn-MX
mim = mim-MX = mim-Latn = mim-Latn-MX
min = min-ID = min-Latn = min-Latn-ID
mio = mio-MX = mio-Latn = mio-Latn-MX
mip = mip-MX = mip-Latn = mip-Latn-MX
miq = miq-NI = miq-Latn = miq-Latn-NI
mir = mir-MX = mir-Latn = mir-Latn-MX
mis = mis-IQ = mis-Hatr = mis-Hatr-IQ
mit = mit-MX = mit-Latn = mit-Latn-MX
miu = miu-MX = miu-Latn = miu-Latn-MX
miw = miw-PG = *miw-Latn = miw-Latn-PG
mix = mix-MX = mix-Latn = mix-Latn-MX
miy = miy-MX = miy-Latn = miy-Latn-MX
miz = miz-MX = miz-Latn = miz-Latn-MX
mjb-Latn = mjb-Latn-TL
mjc = mjc-MX = mjc-Latn = mjc-Latn-MX
mjg-Latn = mjg-Latn-CN
mjh = mjh-TZ = mjh-Latn = mjh-Latn-TZ
mji-Latn = mji-Latn-CN
mjl-Deva = mjl-Deva-IN
mjl-Takr = mjl-Takr-IN
mjn = mjn-PG = mjn-Latn = mjn-Latn-PG
mjt-Beng = mjt-Beng-BD
mjt-Deva = mjt-Deva-IN
mju-Telu = mju-Telu-IN
mjv-Mlym = mjv-Mlym-IN
mjw-Latn = mjw-Latn-IN
mjx-Latn = mjx-Latn-BD
mjz-Deva = mjz-Deva-NP
*mk = mk-Cyrl
*mk = *mk-MK = mk-Cyrl = mk-Cyrl-MK
mk-AL = mk-Cyrl-AL
mk-GR = mk-Cyrl-GR
mkb-Deva = mkb-Deva-IN
mke-Deva = mke-Deva-IN
mkf-Latn = mkf-Latn-NG
*mki-Arab = mki-Arab-PK
mkj-Latn = mkj-Latn-FM
mkl-Latn = mkl-Latn-BJ
mkm-Thai = mkm-Thai-TH
mkn-Latn = mkn-Latn-ID
mkp = mkp-PG = *mkp-Latn = mkp-Latn-PG
mks = mks-MX = mks-Latn = mks-Latn-MX
*mkw-Latn = mkw-Latn-CG
*ml = *ml-IN = ml-Mlym = ml-Mlym-IN
*ml = ml-Mlym
*ml-Arab = ml-Arab-IN
ml-Brai = ml-Brai-IN
mla = mla-VU = mla-Latn = mla-Latn-VU
mle = mle-PG = *mle-Latn = mle-Latn-PG
mlf-Latn = mlf-Latn-LA
mlf-Thai = mlf-Thai-LA
mlh = mlh-PG = mlh-Latn = mlh-Latn-PG
mlk = mlk-KE = mlk-Latn = mlk-Latn-KE
mlp = mlp-PG = *mlp-Latn = mlp-Latn-PG
mlq-Arab = mlq-Arab-SN
mlq-Latn = mlq-Latn-SN
mlr-Latn = mlr-Latn-CM
mls = mls-SD = mls-Latn = mls-Latn-SD
mlu = mlu-SB = mlu-Latn = mlu-Latn-SB
mlv = mlv-VU = mlv-Latn = mlv-Latn-VU
mlw-Latn = mlw-Latn-CM
mlx = mlx-VU = mlx-Latn = mlx-Latn-VU
mmc = mmc-MX = mmc-Latn = mmc-Latn-MX
mmd-Hans = mmd-Hans-CN
mmd-Hant = mmd-Hant-CN
mmn-Latn = mmn-Latn-PH
mmo = mmo-PG = *mmo-Latn = mmo-Latn-PG
mmp = mmp-PG = mmp-Latn = mmp-Latn-PG
mmr-Latn = mmr-Latn-CN
*mmu-Latn = mmu-Latn-CM
mmx = mmx-PG = *mmx-Latn = mmx-Latn-PG
mmy-Latn = mmy-Latn-TD
*mn = mn-CN = *mn-Mong = mn-Mong-CN
*mn = *mn-MN = *mn-Cyrl = *mn-Cyrl-MN
mn-Phag = mn-Phag-MN
mna = mna-PG = *mna-Latn = mna-Latn-PG
mnb-Latn = mnb-Latn-ID
mnc-Mong-x-manchu = mnc-Mong-CN-x-manchu
mnc-Mong-x-oldmanchu = mnc-Mong-CN-x-oldmanchu
*mnf-Latn = mnf-Latn-CM
mng-Latn = mng-Latn-VN
mnh-Latn = mnh-Latn-CD
mni = mni-IN = mni-Beng = mni-Beng-IN
mni-Brai = mni-Brai-IN
mni-Mtei = mni-Mtei-IN
mnj-Arab = mnj-Arab-AF
*mnk-Arab = mnk-Arab-SN
*mnk-Latn = mnk-Latn-SN
mnl = mnl-VU = mnl-Latn = mnl-Latn-VU
mnp-Latn = mnp-Latn-CN
mns-Cyrl = mns-Cyrl-RU
mnv = mnv-SB = mnv-Latn = mnv-Latn-SB
mnw = mnw-MM = mnw-Mymr = mnw-Mymr-MM
mnw-TH = mnw-Mymr-TH
mnx-Latn = mnx-Latn-ID
mnz-Latn = mnz-Latn-ID
mo = mo-Latn
*moa-Latn = moa-Latn-CI
moc = moc-AR = moc-Latn = moc-Latn-AR
moe = moe-CA = moe-Latn = moe-Latn-CA
mog-Latn = mog-Latn-ID
moh = moh-CA = moh-Latn = moh-Latn-CA
mop = mop-BZ = mop-Latn = mop-Latn-BZ
mor-Latn = mor-Latn-SD
mos = mos-BF = *mos-Latn = mos-Latn-BF
mos-Brai = mos-Brai-BF
mou-Latn = mou-Latn-TD
mov-Latn = mov-Latn-US
mox = mox-PG = *mox-Latn = mox-Latn-PG
moy-Latn = moy-Latn-ET
moz-Latn = moz-Latn-TD
mpa = mpa-TZ = mpa-Latn = mpa-Latn-TZ
mpd = mpd-BR = mpd-Latn = mpd-Latn-BR
mpe-Ethi = mpe-Ethi-ET
mpe-Latn = mpe-Latn-ET
mpg-Latn = mpg-Latn-TD
mph = mph-AU = mph-Latn = mph-Latn-AU
mpi-Latn = mpi-Latn-CM
mpj = mpj-AU = mpj-Latn = mpj-Latn-AU
mpl = mpl-PG = mpl-Latn = mpl-Latn-PG
mpm = mpm-MX = mpm-Latn = mpm-Latn-MX
mpo = mpo-PG = mpo-Latn = mpo-Latn-PG
mpp = mpp-PG = *mpp-Latn = mpp-Latn-PG
mps = mps-PG = *mps-Latn = mps-Latn-PG
mpt = mpt-PG = *mpt-Latn = mpt-Latn-PG
mpx = mpx-PG = *mpx-Latn = mpx-Latn-PG
mpz-Thai = mpz-Thai-TH
mqb-Latn = mqb-Latn-CM
mqf-Latn = mqf-Latn-ID
mqj-Latn = mqj-Latn-ID
*mql-Latn = mql-Latn-BJ
mqm-Latn = mqm-Latn-PF
mqn-Latn = mqn-Latn-ID
mqu-Latn = mqu-Latn-SS
mqx-Latn = mqx-Latn-ID
mqy-Latn = mqy-Latn-ID
*mr = *mr-IN = mr-Deva = mr-Deva-IN
*mr = *mr-IN = mr-Deva = mr-Deva-IN
mr-Brai = mr-Brai-IN
mr-Modi = mr-Modi-IN
mra-Thai = mra-Thai-TH
mrd = mrd-NP = mrd-Deva = mrd-Deva-NP
mrg-Beng = mrg-Beng-IN
mrg-Deva = mrg-Deva-IN
mrg-Latn = mrg-Latn-IN
mrh-Latn = mrh-Latn-IN
mrj = mrj-RU = mrj-Cyrl = mrj-Cyrl-RU
mrk = mrk-NC = mrk-Latn = mrk-Latn-NC
mrl-Latn = mrl-Latn-FM
mrn = mrn-SB = mrn-Latn = mrn-Latn-SB
mro-Latn = mro-Latn-BD
mro-Mroo = mro-Mroo-BD
mrq-Latn = mrq-Latn-PF
mrr-Deva = mrr-Deva-IN
mrt-Latn = mrt-Latn-NG
mru = mru-BD = mru-Mroo = mru-Mroo-BD
mrv-Latn = mrv-Latn-PF
mrw-Latn = mrw-Latn-PH
mrz-Latn = mrz-Latn-ID
*ms = *ms-Latn
*ms = *ms-MY = *ms-Latn = *ms-Latn-MY
*ms-Arab = ms-Arab-MY
*ms-BN = *ms-Latn-BN
ms-CC = ms-Arab-CC
ms-ID = ms-Arab-ID
msb-Latn = msb-Latn-PH
msc-Latn = msc-Latn-GN
mse-Latn = mse-Latn-TD
msh = msh-MG = msh-Latn = msh-Latn-MG
msi-Latn = msi-Latn-MY
msk-Latn = msk-Latn-PH
msm-Latn = msm-Latn-PH
msn = msn-VU = msn-Latn = msn-Latn-VU
msv-Latn = msv-Latn-CM
msw-Latn = msw-Latn-GW
msy = msy-PG = msy-Latn = msy-Latn-PG
*mt = *mt-MT = mt-Latn = mt-Latn-MT
*mt = *mt-MT = mt-Latn = mt-Latn-MT
mt-Arab = mt-Arab-MT
mt-Brai = mt-Brai-MT
mta-Latn = mta-Latn-PH
mtd-Latn = mtd-Latn-ID
mte = mte-SB = mte-Latn = mte-Latn-SB
mtf = mtf-PG = *mtf-Latn = mtf-Latn-PG
mtg-Latn = mtg-Latn-ID
mti = mti-PG = *mti-Latn = mti-Latn-PG
mtj-Latn = mtj-Latn-ID
mto = mto-MX = mto-Latn = mto-Latn-MX
mtp = mtp-BO = mtp-Latn = mtp-Latn-BO
mtq-Latn = mtq-Latn-VN
mtr = mtr-IN = mtr-Deva = mtr-Deva-IN
mts = mts-PE = mts-Latn = mts-Latn-PE
mtt = mtt-VU = mtt-Latn = mtt-Latn-VU
mtu = mtu-MX = mtu-Latn = mtu-Latn-MX
mtv = mtv-PG = mtv-Latn = mtv-Latn-PG
mtx = mtx-MX = mtx-Latn = mtx-Latn-MX
*mua = *mua-CM = mua-Latn = mua-Latn-CM
mue = mue-EC = mue-Latn = mue-Latn-EC
mug-Latn = mug-Latn-CM
muh-Latn = muh-Latn-SS
muk-Tibt = muk-Tibt-NP
mum = mum-PG = mum-Latn = mum-Latn-PG
mup-Deva = mup-Deva-IN
*mur-Latn = mur-Latn-SS
mus = mus-US = mus-Latn = mus-Latn-US
mut-Deva = mut-Deva-IN
mux = mux-PG = mux-Latn = mux-Latn-PG
muy-Latn = muy-Latn-CM
muz-Ethi = muz-Ethi-ET
mva = mva-PG = *mva-Latn = mva-Latn-PG
mve-Arab = mve-Arab-PK
mvf-Mong = mvf-Mong-CN
mvf-Phag = mvf-Phag-CN
mvg = mvg-MX = mvg-Latn = mvg-Latn-MX
mvn = mvn-PG = *mvn-Latn = mvn-Latn-PG
mvo = mvo-SB = mvo-Latn = mvo-Latn-SB
mvp-Latn = mvp-Latn-ID
mvv-Latn = mvv-Latn-MY
mvy = mvy-PK = *mvy-Arab = mvy-Arab-PK
mwc = mwc-PG = mwc-Latn = mwc-Latn-PG
mwe = mwe-TZ = mwe-Latn = mwe-Latn-TZ
mwf = mwf-AU = mwf-Latn = mwf-Latn-AU
mwg = mwg-PG = mwg-Latn = mwg-Latn-PG
mwh = mwh-PG = mwh-Latn = mwh-Latn-PG
mwi = mwi-VU = mwi-Latn = mwi-Latn-VU
mwk = mwk-ML = mwk-Latn = mwk-Latn-ML
mwl-Latn = mwl-Latn-PT
mwm-Latn = mwm-Latn-TD
mwn = mwn-ZM = mwn-Latn = mwn-Latn-ZM
mwo = mwo-VU = mwo-Latn = mwo-Latn-VU
mwp = mwp-AU = mwp-Latn = mwp-Latn-AU
mwq-Latn = mwq-Latn-MM
mwr = mwr-IN = mwr-Deva = mwr-Deva-IN
mwt-Mymr = mwt-Mymr-MM
mwt-Thai = mwt-Thai-TH
mwv = mwv-ID = mwv-Latn = mwv-Latn-ID
mww = mww-CN = mww-Latn = mww-Latn-CN
mww-Hmng = mww-Hmng-CN
mww-Laoo = mww-Laoo-LA
mww-Plrd = mww-Plrd-CN
mww-Thai = mww-Thai-TH
mxa = mxa-MX = mxa-Latn = mxa-Latn-MX
mxb = mxb-MX = mxb-Latn = mxb-Latn-MX
mxc = mxc-ZW = mxc-Latn = mxc-Latn-ZW
mxe = mxe-VU = mxe-Latn = mxe-Latn-VU
mxf-Latn = mxf-Latn-CM
mxg-Latn = mxg-Latn-AO
mxj-Latn = mxj-Latn-IN
mxm = mxm-PG = *mxm-Latn = mxm-Latn-PG
mxp = mxp-MX = mxp-Latn = mxp-Latn-MX
mxq = mxq-MX = mxq-Latn = mxq-Latn-MX
mxs = mxs-MX = mxs-Latn = mxs-Latn-MX
mxt = mxt-MX = mxt-Latn = mxt-Latn-MX
mxu-Latn = mxu-Latn-CM
mxv = mxv-MX = mxv-Latn = mxv-Latn-MX
mxw = mxw-PG = mxw-Latn = mxw-Latn-PG
mxy = mxy-MX = mxy-Latn = mxy-Latn-MX
*my = *my-MM = my-Mymr = my-Mymr-MM
*my = my-Mymr
my-Brai = my-Brai-MM
myb-Latn = myb-Latn-TD
mye-Latn = mye-Latn-GA
myf-Latn = myf-Latn-ET
*myk-Latn = myk-Latn-ML
myl-Latn = myl-Latn-ID
*mym-Ethi = mym-Ethi-ET
*mym-Latn = mym-Latn-ET
myp = myp-BR = myp-Latn = myp-Latn-BR
myr = myr-PE = myr-Latn = myr-Latn-PE
myu = myu-BR = myu-Latn = myu-Latn-BR
myv = myv-RU = myv-Cyrl = myv-Cyrl-RU
myw = myw-PG = *myw-Latn = myw-Latn-PG
myx = myx-UG = myx-Latn = myx-Latn-UG
myy = myy-CO = myy-Latn = myy-Latn-CO
myz = myz-IR = myz-Mand = myz-Mand-IR
mza = mza-MX = mza-Latn = mza-Latn-MX
mzb-Arab = mzb-Arab-DZ
mzb-Latn = mzb-Latn-DZ
mzb-Tfng = mzb-Tfng-DZ
mzh = mzh-AR = mzh-Latn = mzh-Latn-AR
mzi = mzi-MX = mzi-Latn = mzi-Latn-MX
mzj-Latn = mzj-Latn-LR
*mzk-Latn = mzk-Latn-NG
mzl = mzl-MX = mzl-Latn = mzl-Latn-MX
*mzm-Latn = mzm-Latn-NG
*mzn = *mzn-IR = mzn-Arab = mzn-Arab-IR
mzp = mzp-BO = *mzp-Latn = mzp-Latn-BO
mzq-Latn = mzq-Latn-ID
mzu = mzu-PG = mzu-Latn = mzu-Latn-PG
mzv-Latn = mzv-Latn-CF
*mzw-Latn = mzw-Latn-GH
mzz = mzz-PG = *mzz-Latn = mzz-Latn-PG
na = na-NR = na-Latn = na-Latn-NR
na = na-NR = na-Latn = na-Latn-NR
nab = nab-BR = nab-Latn = nab-Latn-BR
nac = nac-PG = *nac-Latn = nac-Latn-PG
naf = naf-PG = *naf-Latn = naf-Latn-PG
nag-Latn = nag-Latn-IN
nak = nak-PG = *nak-Latn = nak-Latn-PG
nal = nal-PG = nal-Latn = nal-Latn-PG
nan = nan-CN = nan-Hans = nan-Hans-CN
nan-Bopo = nan-Bopo-TW
nan-Kana = nan-Kana-TW
nan-Latn = nan-Latn-CN
nap = nap-IT = nap-Latn = nap-Latn-IT
*naq = *naq-NA = naq-Latn = naq-Latn-NA
nas = nas-PG = *nas-Latn = nas-Latn-PG
nat-Latn = nat-Latn-NG
naw-Latn = naw-Latn-GH
nax = nax-PG = nax-Latn = nax-Latn-PG
nay = nay-AU = nay-Latn = nay-Latn-AU
*nb = nb-Latn
*nb = *nb-NO = nb-Latn = nb-Latn-NO
*nb-SJ = nb-Latn-SJ
nba-Latn = nba-Latn-AO
nbc-Latn = nbc-Latn-IN
nbe-Latn = nbe-Latn-IN
nbf = nbf-CN
nbh-Latn = nbh-Latn-NG
nbi-Latn = nbi-Latn-IN
nbm-Latn = nbm-Latn-CF
nbq-Latn = nbq-Latn-ID
nbt-Deva = nbt-Deva-IN
nbt-Latn = nbt-Latn-IN
nbu-Latn = nbu-Latn-IN
nbw-Latn = nbw-Latn-CD
nca = nca-PG = *nca-Latn = nca-Latn-PG
ncb-Deva = ncb-Deva-IN
ncb-Latn = ncb-Latn-IN
ncd-Deva = ncd-Deva-NP
nce = nce-PG = *nce-Latn = nce-Latn-PG
ncf = ncf-PG = *ncf-Latn = ncf-Latn-PG
ncg-Latn = ncg-Latn-CA
nch = nch-MX = nch-Latn = nch-Latn-MX
nci = nci-MX = nci-Latn = nci-Latn-MX
ncj = ncj-MX = ncj-Latn = ncj-Latn-MX
ncl = ncl-MX = ncl-Latn = ncl-Latn-MX
ncm = ncm-PG = ncm-Latn = ncm-Latn-PG
nco = nco-PG = *nco-Latn = nco-Latn-PG
ncr-Latn = ncr-Latn-CM
nct-Beng = nct-Beng-IN
nct-Latn = nct-Latn-IN
*ncu-Latn = ncu-Latn-GH
ncx = ncx-MX = ncx-Latn = ncx-Latn-MX
*nd = *nd-ZW = nd-Latn = nd-Latn-ZW
*nd = *nd-ZW = nd-Latn = nd-Latn-ZW
ndb-Latn = ndb-Latn-CM
ndc = ndc-MZ = ndc-Latn = ndc-Latn-MZ
ndh = ndh-TZ = ndh-Latn = ndh-Latn-TZ
ndi-Latn = ndi-Latn-NG
ndj = ndj-TZ = ndj-Latn = ndj-Latn-TZ
ndm-Latn = ndm-Latn-TD
ndp = ndp-UG = ndp-Latn = ndp-Latn-UG
*nds = nds-DE = nds-Latn = nds-Latn-DE
*nds = nds-DE = nds-Latn = nds-Latn-DE
ndu-Latn = ndu-Latn-CM
ndv-Latn = ndv-Latn-SN
ndx-Latn = ndx-Latn-ID
ndy-Latn = ndy-Latn-CF
ndz-Latn = ndz-Latn-SS
*ne = ne-Deva
*ne = *ne-NP = ne-Deva = ne-Deva-NP
ne-BT = ne-Deva-BT
ne-Brai = ne-Brai-NP
ne-Newa = ne-Newa-NP
*neb-Latn = neb-Latn-CI
nen = nen-NC = nen-Latn = nen-Latn-NC
neq = neq-MX = neq-Latn = neq-Latn-MX
net = net-PG = net-Latn = net-Latn-PG
neu-Latn = neu-Latn-??
new = new-NP = new-Deva = new-Deva-NP
new-Newa = new-Newa-NP
new-Qabb = new-Qabb-NP
nez-Latn = nez-Latn-US
nfa-Latn = nfa-Latn-ID
nfl = nfl-SB = nfl-Latn = nfl-Latn-SB
*nfr-Latn = nfr-Latn-GH
nfu-Latn = nfu-Latn-CM
ng = ng-NA = ng-Latn = ng-Latn-NA
*nga-Latn = nga-Latn-CD
*ngb-Latn = ngb-Latn-CD
ngc-Latn = ngc-Latn-CD
ngj-Latn = ngj-Latn-CM
ngl = ngl-MZ = ngl-Latn = ngl-Latn-MZ
ngo = ngo-TZ = ngo-Latn = ngo-Latn-TZ
ngp = ngp-TZ = ngp-Latn = ngp-Latn-TZ
ngq = ngq-TZ = ngq-Latn = ngq-Latn-TZ
ngr = ngr-SB = ngr-Latn = ngr-Latn-SB
ngu = ngu-MX = ngu-Latn = ngu-Latn-MX
ngz-Latn = ngz-Latn-CG
*nhb-Latn = nhb-Latn-CI
nhd = nhd-PY = nhd-Latn = nhd-Latn-PY
nhe = nhe-MX = nhe-Latn = nhe-Latn-MX
nhg = nhg-MX = nhg-Latn = nhg-Latn-MX
nhi = nhi-MX = nhi-Latn = nhi-Latn-MX
nhm = nhm-MX = nhm-Latn = nhm-Latn-MX
nhn = nhn-MX = nhn-Latn = nhn-Latn-MX
nho = nho-PG = nho-Latn = nho-Latn-PG
nhp = nhp-MX = nhp-Latn = nhp-Latn-MX
nhq = nhq-MX = nhq-Latn = nhq-Latn-MX
nhr = nhr-BW = nhr-Latn = nhr-Latn-BW
nhu-Latn = nhu-Latn-CM
nhw = nhw-MX = nhw-Latn = nhw-Latn-MX
nhx = nhx-MX = nhx-Latn = nhx-Latn-MX
nhy = nhy-MX = nhy-Latn = nhy-Latn-MX
nia-Latn = nia-Latn-ID
nie-Latn = nie-Latn-TD
nif = nif-PG = *nif-Latn = nif-Latn-PG
nih = nih-TZ = nih-Latn = nih-Latn-TZ
nii = nii-PG = *nii-Latn = nii-Latn-PG
nij = nij-ID = nij-Latn = nij-Latn-ID
nim = nim-TZ = nim-Latn = nim-Latn-TZ
*nin-Latn = nin-Latn-NG
nio-Cyrl = nio-Cyrl-RU
niq = niq-KE = niq-Latn = niq-Latn-KE
nir-Latn = nir-Latn-ID
nit-Telu = nit-Telu-IN
niu = niu-NU = niu-Latn = niu-Latn-NU
niu = niu-NU = niu-Latn = niu-Latn-NU
niv-Cyrl = niv-Cyrl-RU
niv-Latn = niv-Latn-RU
niw = niw-PG = niw-Latn = niw-Latn-PG
*niy-Latn = niy-Latn-CD
nja-Latn = nja-Latn-NG
njh-Latn = njh-Latn-IN
njm-Latn = njm-Latn-IN
njn-Latn = njn-Latn-IN
njo = njo-IN = njo-Latn = njo-Latn-IN
njy-Latn = njy-Latn-CM
njz-Beng = njz-Beng-IN
njz-Latn = njz-Latn-IN
nka = nka-ZM = nka-Latn = nka-Latn-ZM
nkb-Latn = nkb-Latn-IN
nkd-Latn = nkd-Latn-IN
nkf-Latn = nkf-Latn-IN
nkg = nkg-PG = nkg-Latn = nkg-Latn-PG
nki-Beng = nki-Beng-IN
nki-Latn = nki-Latn-IN
nkk = nkk-VU = nkk-Latn = nkk-Latn-VU
nkn-Latn = nkn-Latn-AO
*nko-Latn = nko-Latn-GH
nkr-Latn = nkr-Latn-FM
nku-Latn = nku-Latn-CI
nkw-Latn = nkw-Latn-CD
*nl = nl-Latn
*nl = *nl-NL = nl-Latn = nl-Latn-NL
*nl-AW = nl-Latn-AW
*nl-BE = nl-Latn-BE
nl-Brai = nl-Brai-NL
*nl-SR = nl-Latn-SR
nla-Latn = nla-Latn-CM
nlc-Latn = nlc-Latn-ID
nle = nle-KE = nle-Latn = nle-Latn-KE
nlg = nlg-SB = nlg-Latn = nlg-Latn-SB
nlk-Latn = nlk-Latn-ID
nlv = nlv-MX = nlv-Latn = nlv-Latn-MX
nlz = nlz-SB = nlz-Latn = nlz-Latn-SB
nma-Latn = nma-Latn-IN
nmb = nmb-VU = nmb-Latn = nmb-Latn-VU
nmc-Latn = nmc-Latn-TD
nme-Latn = nme-Latn-IN
nmf-Latn = nmf-Latn-IN
*nmg = *nmg-CM = nmg-Latn = nmg-Latn-CM
nmh-Latn = nmh-Latn-IN
nmk = nmk-VU = nmk-Latn = nmk-Latn-VU
nmm-Deva = nmm-Deva-NP
nmm-Tibt = nmm-Tibt-NP
nmo-Beng = nmo-Beng-IN
nmo-Latn = nmo-Latn-IN
nmq-Latn = nmq-Latn-ZW
nmw = nmw-PG = nmw-Latn = nmw-Latn-PG
nmx = nmx-PG = nmx-Latn = nmx-Latn-PG
*nmz-Latn = nmz-Latn-TG
*nn = *nn-NO = nn-Latn = nn-Latn-NO
*nn = *nn-NO = nn-Latn = nn-Latn-NO
nna = nna-AU = nna-Latn = nna-Latn-AU
nnb-Latn = nnb-Latn-CD
nnc-Latn = nnc-Latn-TD
nnd = nnd-VU = nnd-Latn = nnd-Latn-VU
nnf = nnf-PG = *nnf-Latn = nnf-Latn-PG
nng-Beng = nng-Beng-IN
nng-Latn = nng-Latn-IN
*nnh = *nnh-CM = nnh-Latn = nnh-Latn-CM
nnj-Latn = nnj-Latn-ET
nnk = nnk-PG = *nnk-Latn = nnk-Latn-PG
nnl-Latn = nnl-Latn-IN
nnm = nnm-PG = *nnm-Latn = nnm-Latn-PG
nnp-Deva = nnp-Deva-IN
nnp-Latn = nnp-Latn-IN
nnq = nnq-TZ = nnq-Latn = nnq-Latn-TZ
nnw-Latn = nnw-Latn-BF
no = no-Latn
no = no-NO = no-Latn = no-Latn-NO
noa = noa-CO = noa-Latn = noa-Latn-CO
noc = noc-PG = noc-Latn = noc-Latn-PG
nod = nod-TH = *nod-Lana = nod-Lana-TH
nod-Thai = nod-Thai-TH
noe = noe-IN = noe-Deva = noe-Deva-IN
nog-Cyrl = nog-Cyrl-RU
noi-Deva = noi-Deva-IN
non = non-SE = non-Runr = non-Runr-SE
nop = nop-PG = *nop-Latn = nop-Latn-PG
nos-Yiii-x-traditional = nos-Yiii-CN-x-traditional
not = not-PE = not-Latn = not-Latn-PE
nou = nou-PG = *nou-Latn = nou-Latn-PG
nph-Latn = nph-Latn-IN
npi-Brai = npi-Brai-NP
npi-Deva = npi-Deva-NP
npl = npl-MX = npl-Latn = npl-Latn-MX
npo-Latn = npo-Latn-IN
nps-Latn = nps-Latn-ID
npu-Latn = npu-Latn-IN
npy-Latn = npy-Latn-ID
nqg-Latn = nqg-Latn-BJ
nqo = nqo-GN = nqo-Nkoo = nqo-Nkoo-GN
nqo = nqo-Nkoo
*nr = *nr-ZA = nr-Latn = nr-Latn-ZA
*nr = *nr-ZA = nr-Latn = nr-Latn-ZA
nr-Brai = nr-Brai-ZA
nra-Latn = nra-Latn-GA
*nrb-Latn = nrb-Latn-ER
nre-Latn = nre-Latn-IN
nrf-Latn = nrf-Latn-JE
nrg = nrg-VU = nrg-Latn = nrg-Latn-VU
nri-Latn = nri-Latn-IN
nrz = nrz-PG = nrz-Latn = nrz-Latn-PG
nsa-Latn = nsa-Latn-IN
nsd-Yiii-x-traditional = nsd-Yiii-CN-x-traditional
nse = nse-ZM = nse-Latn = nse-Latn-ZM
nsk = nsk-CA = nsk-Cans = nsk-Cans-CA
nsk-Latn = nsk-Latn-CA
nsm-Latn = nsm-Latn-IN
nsn = nsn-PG = *nsn-Latn = nsn-Latn-PG
*nso = *nso-ZA = nso-Latn = nso-Latn-ZA
*nso = *nso-ZA = nso-Latn = nso-Latn-ZA
nso-Brai = nso-Brai-ZA
nss = nss-PG = *nss-Latn = nss-Latn-PG
nst-Latn = nst-Latn-MM
nsu = nsu-MX = nsu-Latn = nsu-Latn-MX
nsv-Yiii-x-traditional = nsv-Yiii-CN-x-traditional
nsx-Latn = nsx-Latn-AO
ntj = ntj-AU = ntj-Latn = ntj-Latn-AU
ntk = ntk-TZ = ntk-Latn = ntk-Latn-TZ
*ntm-Latn = ntm-Latn-BJ
nto-Latn = nto-Latn-CD
ntp = ntp-MX = ntp-Latn = ntp-Latn-MX
*ntr-Latn = ntr-Latn-GH
ntu = ntu-SB = ntu-Latn = ntu-Latn-SB
ntx-Latn = ntx-Latn-MM
nty-Yiii = nty-Yiii-VN
ntz-Arab = ntz-Arab-IR
nua = nua-NC = nua-Latn = nua-Latn-NC
nuf-Latn = nuf-Latn-CN
*nui-Latn = nui-Latn-GQ
nuj = nuj-UG = nuj-Latn = nuj-Latn-UG
num-Latn = num-Latn-TO
nun-Latn = nun-Latn-MM
*nup-Latn = nup-Latn-NG
nuq = nuq-PG = nuq-Latn = nuq-Latn-PG
*nus = *nus-SS = nus-Latn = nus-Latn-SS
nut-Latn = nut-Latn-VN
*nuv-Latn = nuv-Latn-BF
nuy = nuy-AU = nuy-Latn = nuy-Latn-AU
nuz = nuz-MX = nuz-Latn = nuz-Latn-MX
nv = nv-US = nv-Latn = nv-Latn-US
nvm = nvm-PG = nvm-Latn = nvm-Latn-PG
*nwb-Latn = nwb-Latn-CI
nwi = nwi-VU = nwi-Latn = nwi-Latn-VU
nxa-Latn = nxa-Latn-TL
nxd-Latn = nxd-Latn-CD
nxl-Latn = nxl-Latn-ID
nxq = nxq-CN = nxq-Latn = nxq-Latn-CN
nxq-Nkgb = nxq-Nkgb-CN
nxq-Qabo = nxq-Qabo-CN
nxr = nxr-PG = *nxr-Latn = nxr-Latn-PG
*ny = ny-Latn
*ny = ny-MW = ny-Latn = ny-Latn-MW
ny-Brai = ny-Brai-MW
nyd = nyd-KE = nyd-Latn = nyd-Latn-KE
nyf = nyf-KE = nyf-Latn = nyf-Latn-KE
nyi-Latn = nyi-Latn-SD
nyk-Latn = nyk-Latn-AO
nym = nym-TZ = nym-Latn = nym-Latn-TZ
*nyn = *nyn-UG = nyn-Latn = nyn-Latn-UG
nyo = nyo-UG = nyo-Latn = nyo-Latn-UG
nyq-Arab = nyq-Arab-IR
nyr-Latn = nyr-Latn-MW
nyu-Latn = nyu-Latn-MZ
nyy = nyy-TZ = nyy-Latn = nyy-Latn-TZ
nza-Latn = nza-Latn-CM
nzb-Latn = nzb-Latn-GA
nzi = nzi-GH = nzi-Latn = nzi-Latn-GH
nzk-Latn = nzk-Latn-CF
nzm-Latn = nzm-Latn-IN
nzu-Latn = nzu-Latn-CG
nzy-Latn = nzy-Latn-TD
obo-Latn = obo-Latn-PH
obr-Mymr = obr-Mymr-MM
*oc = oc-FR = oc-Latn = oc-Latn-FR
oca = oca-PE = oca-Latn = oca-Latn-PE
odk-Arab = odk-Arab-PK
odu-Latn = odu-Latn-NG
*ogc-Latn = ogc-Latn-NG
ogo-Latn = ogo-Latn-NG
oj-Cans = oj-Cans-CA
oj-Latn = oj-Latn-CA
ojb-Cans = ojb-Cans-CA
ojb-Latn = ojb-Latn-CA
ojg-Cans = ojg-Cans-CA
ojg-Latn = ojg-Latn-CA
ojs-Cans = ojs-Cans-CA
ojv = ojv-SB = ojv-Latn = ojv-Latn-SB
ojw-Cans = ojw-Cans-CA
ojw-Latn = ojw-Latn-CA
oka-Latn = oka-Latn-CA
*okr-Latn = okr-Latn-NG
oku-Latn = oku-Latn-CM
okv = okv-PG = *okv-Latn = okv-Latn-PG
ola-Tibt = ola-Tibt-NP
old = old-TZ = old-Latn = old-Latn-TZ
olo-Latn = olo-Latn-RU
olr = olr-VU = olr-Latn = olr-Latn-VU
olt-Latn = olt-Latn-LT
*om = *om-ET = om-Latn = om-Latn-ET
*om = om-Latn
om-Ethi = om-Ethi-ET
omb = omb-VU = omb-Latn = omb-Latn-VU
omi-Latn = omi-Latn-CD
omw = omw-PG = omw-Latn = omw-Latn-PG
one-Latn = one-Latn-CA
ong = ong-PG = *ong-Latn = ong-Latn-PG
onn = onn-PG = *onn-Latn = onn-Latn-PG
ono-Latn = ono-Latn-CA
onp-Deva = onp-Deva-IN
onp-Latn = onp-Latn-IN
onr = onr-PG = onr-Latn = onr-Latn-PG
ons = ons-PG = *ons-Latn = ons-Latn-PG
onu = onu-VU = onu-Latn = onu-Latn-VU
ood = ood-US = ood-Latn = ood-Latn-US
opm = opm-PG = *opm-Latn = opm-Latn-PG
*or = *or-IN = or-Orya = or-Orya-IN
*or = *or-IN = or-Orya = or-Orya-IN
or-Brai = or-Brai-IN
orc = orc-KE = orc-Latn = orc-Latn-KE
ore = ore-PE = ore-Latn = ore-Latn-PE
oro = oro-PG = *oro-Latn = oro-Latn-PG
ort-Telu = ort-Telu-IN
*oru-Arab = oru-Arab-PK
ory = ory-IN = ory-Orya = ory-Orya-IN
ory-Brai = ory-Brai-IN
*os = *os-GE = os-Cyrl = os-Cyrl-GE
os-Geor = os-Geor-RU
os-Latn = os-Latn-RU
osa-Latn = osa-Latn-US
osa-Osge = osa-Osge-US
osc-Ital = osc-Ital-IT
osc-Latn = osc-Latn-IT
osi-Java = osi-Java-ID
osu = osu-PG = osu-Latn = osu-Latn-PG
*ota-Arab = ota-Arab-??
otd-Latn = otd-Latn-ID
ote = ote-MX = ote-Latn = ote-Latn-MX
otk = otk-MN = otk-Orkh = otk-Orkh-MN
otm = otm-MX = otm-Latn = otm-Latn-MX
otn = otn-MX = otn-Latn = otn-Latn-MX
otq = otq-MX = otq-Latn = otq-Latn-MX
otr-Latn = otr-Latn-SD
ots = ots-MX = ots-Latn = ots-Latn-MX
ott = ott-MX = ott-Latn = ott-Latn-MX
otw-Latn = otw-Latn-CA
otx = otx-MX = otx-Latn = otx-Latn-MX
oub-Latn = oub-Latn-LR
ovd-Latn = ovd-Latn-SE
owi = owi-PG = owi-Latn = owi-Latn-PG
oyd-Latn = oyd-Latn-ET
oym = oym-BR = oym-Latn = oym-Latn-BR
*ozm-Latn = ozm-Latn-CM
*pa = *pa-Guru
*pa = pa-IN = *pa-Guru = *pa-Guru-IN
*pa = pa-PK = *pa-Arab = *pa-Arab-PK
pa-Khoj = pa-Khoj-IN
pab = pab-BR = pab-Latn = pab-Latn-BR
pac-Laoo = pac-Laoo-LA
pac-Latn = pac-Latn-VN
pad = pad-BR = pad-Latn = pad-Latn-BR
pae-Latn = pae-Latn-CD
pag = pag-PH = pag-Latn = pag-Latn-PH
pag-Brai = pag-Brai-PH
pah = pah-BR = pah-Latn = pah-Latn-BR
pak = pak-BR = pak-Latn = pak-Latn-BR
pal = pal-IR = pal-Phli = pal-Phli-IR
pal-Phlp = pal-Phlp-CN
pam = pam-PH = pam-Latn = pam-Latn-PH
pam-Brai = pam-Brai-PH
pao-Latn = pao-Latn-US
pap = pap-AW = pap-Latn = pap-Latn-AW
pap-BQ = pap-Latn-BQ
pap-CW = pap-Latn-CW
pau = pau-PW = pau-Latn = pau-Latn-PW
pav = pav-BR = pav-Latn = pav-Latn-BR
pbb = pbb-CO = pbb-Latn = pbb-Latn-CO
pbc = pbc-GY = pbc-Latn = pbc-Latn-GY
pbh = pbh-VE = pbh-Latn = pbh-Latn-VE
*pbi-Latn = pbi-Latn-CM
pbo-Latn = pbo-Latn-GW
pbp-Latn = pbp-Latn-GN
pbs = pbs-MX = pbs-Latn = pbs-Latn-MX
pbt-Arab = pbt-Arab-AF
pbu = pbu-PK = pbu-Arab = pbu-Arab-PK
pbv-Latn = pbv-Latn-IN
pca = pca-MX = pca-Latn = pca-Latn-MX
pcc-Hani = pcc-Hani-CN
pcc-Latn = pcc-Latn-CN
pcd = pcd-FR = pcd-Latn = pcd-Latn-FR
pce-Mymr = pce-Mymr-MM
pcg-Knda = pcg-Knda-IN
pcg-Mlym = pcg-Mlym-IN
*pcg-Taml = pcg-Taml-IN
pci-Deva = pci-Deva-IN
pci-Orya = pci-Orya-IN
pcj-Telu = pcj-Telu-IN
pck-Latn = pck-Latn-IN
pcm = pcm-NG = *pcm-Latn = pcm-Latn-NG
pdc = pdc-US = pdc-Latn = pdc-Latn-US
pdt = pdt-CA = pdt-Latn = pdt-Latn-CA
pdu-Latn = pdu-Latn-MM
ped = ped-PG = *ped-Latn = ped-Latn-PG
peg-Orya = peg-Orya-IN
pem-Latn = pem-Latn-CD
peo = peo-IR = peo-Xpeo = peo-Xpeo-IR
pep = pep-PG = pep-Latn = pep-Latn-PG
pes-Arab = pes-Arab-IR
pex = pex-PG = *pex-Latn = pex-Latn-PG
pez-Latn = pez-Latn-MY
pfe-Latn = pfe-Latn-CM
pfl = pfl-DE = pfl-Latn = pfl-Latn-DE
pga-Latn = pga-Latn-SS
pgg-Deva = pgg-Deva-IN
pgk = pgk-VU = pgk-Latn = pgk-Latn-VU
pgl-Ogam = pgl-Ogam-IE
phk-Mymr = phk-Mymr-IN
*phl-Arab = phl-Arab-PK
phn = phn-LB = phn-Phnx = phn-Phnx-LB
pho-Laoo = pho-Laoo-LA
phr = phr-PK = phr-Arab = phr-Arab-PK
pi-Deva = pi-Deva-IN
pi-Mymr = pi-Mymr-IN
pi-Sinh = pi-Sinh-IN
pi-Thai = pi-Thai-IN
pia = pia-MX = pia-Latn = pia-Latn-MX
pib = pib-PE = pib-Latn = pib-Latn-PE
pid = pid-VE = pid-Latn = pid-Latn-VE
pif-Latn = pif-Latn-FM
*pil-Latn = pil-Latn-BJ
pio = pio-CO = pio-Latn = pio-Latn-CO
*pip-Latn = pip-Latn-NG
pir = pir-BR = pir-Latn = pir-Latn-BR
pis = pis-SB = pis-Latn = pis-Latn-SB
piu = piu-AU = piu-Latn = piu-Latn-AU
piv = piv-SB = piv-Latn = piv-Latn-SB
piy-Latn = piy-Latn-NG
pjt = pjt-AU = pjt-Latn = pjt-Latn-AU
pka = pka-IN = pka-Brah = pka-Brah-IN
pkb = pkb-KE = pkb-Latn = pkb-Latn-KE
pkh-Deva = pkh-Deva-BD
pkh-Latn = pkh-Latn-BD
pko = pko-KE = pko-Latn = pko-Latn-KE
pkp-Latn = pkp-Latn-CK
pkr-Mlym = pkr-Mlym-IN
*pl = pl-Latn
*pl = *pl-PL = pl-Latn = pl-Latn-PL
pl-Brai = pl-Brai-PL
pl-UA = pl-Latn-UA
pla = pla-PG = *pla-Latn = pla-Latn-PG
plc-Latn = plc-Latn-PH
plg = plg-AR = plg-Latn = plg-Latn-AR
plj-Latn = plj-Latn-NG
plk-Arab = plk-Arab-PK
pll-Mymr = pll-Mymr-MM
plp-Deva = plp-Deva-NP
pls = pls-MX = pls-Latn = pls-Latn-MX
plt = plt-MG = plt-Latn = plt-Latn-MG
plt-Brai = plt-Brai-MG
plu = plu-BR = plu-Latn = plu-Latn-BR
plv-Latn = plv-Latn-PH
plw-Latn = plw-Latn-PH
pma = pma-VU = pma-Latn = pma-Latn-VU
pmf-Latn = pmf-Latn-ID
pmq = pmq-MX = pmq-Latn = pmq-Latn-MX
pms = pms-IT = pms-Latn = pms-Latn-IT
pmt-Latn = pmt-Latn-PF
pmx-Latn = pmx-Latn-IN
pmy-Latn = pmy-Latn-ID
pnb = pnb-PK = pnb-Arab = pnb-Arab-PK
pnb-Khoj = pnb-Khoj-PK
pnb-x-landa-pk = pnb-x-landa-pk = pnb-x-landa-pk = pnb-x-landa-pk
pne-Latn = pne-Latn-MY
*png-Latn = png-Latn-NG
pnh-Latn = pnh-Latn-CK
pnn = pnn-PG = *pnn-Latn = pnn-Latn-PG
pno = pno-PE = pno-Latn = pno-Latn-PE
pnt = pnt-GR = pnt-Grek = pnt-Grek-GR
pnt-Cyrl = pnt-Cyrl-GR
pnt-Latn = pnt-Latn-GR
pny-Latn = pny-Latn-CM
pnz-Latn = pnz-Latn-CF
poc = poc-GT = poc-Latn = poc-Latn-GT
poe = poe-MX = poe-Latn = poe-Latn-MX
pof-Latn = pof-Latn-CD
poh = poh-GT = poh-Latn = poh-Latn-GT
poi = poi-MX = poi-Latn = poi-Latn-MX
pon = pon-FM = pon-Latn = pon-Latn-FM
pos = pos-MX = pos-Latn = pos-Latn-MX
pot-Latn = pot-Latn-US
pov-Latn = pov-Latn-GW
pow = pow-MX = pow-Latn = pow-Latn-MX
poy = poy-TZ = poy-Latn = poy-Latn-TZ
ppk-Latn = ppk-Latn-ID
ppl = ppl-SV = ppl-Latn = ppl-Latn-SV
ppo = ppo-PG = *ppo-Latn = ppo-Latn-PG
pps = pps-MX = pps-Latn = pps-Latn-MX
ppt = ppt-PG = ppt-Latn = ppt-Latn-PG
pqm-Latn = pqm-Latn-CA
pra = pra-PK = pra-Khar = pra-Khar-PK
prd = prd-IR = prd-Arab = prd-Arab-IR
prf-Latn = prf-Latn-PH
*prg = *prg-001 = prg-Latn = prg-Latn-001
pri = pri-NC = pri-Latn = pri-Latn-NC
prk-Latn = prk-Latn-MM
prm = prm-PG = prm-Latn = prm-Latn-PG
prq = prq-PE = prq-Latn = prq-Latn-PE
prs-Arab = prs-Arab-AF
prt-Thai = prt-Thai-TH
prx-Arab = prx-Arab-IN
prx-Tibt = prx-Tibt-IN
*ps = *ps-AF = ps-Arab = ps-Arab-AF
*ps = ps-Arab
psa-Latn = psa-Latn-ID
pse-Latn = pse-Latn-ID
psi-Arab = psi-Arab-AF
psq = psq-PG = psq-Latn = psq-Latn-PG
pss = pss-PG = *pss-Latn = pss-Latn-PG
pst-Arab = pst-Arab-PK
*pt = *pt-BR = pt-Latn = pt-Latn-BR
*pt = pt-Latn
*pt-AO = pt-Latn-AO
pt-Brai = pt-Brai-PT
*pt-CV = pt-Latn-CV
*pt-GW = pt-Latn-GW
*pt-MO = pt-Latn-MO
*pt-MZ = pt-Latn-MZ
*pt-PT = pt-Latn-PT
*pt-ST = pt-Latn-ST
*pt-TL = pt-Latn-TL
pta = pta-PY = pta-Latn = pta-Latn-PY
ptp = ptp-PG = *ptp-Latn = ptp-Latn-PG
ptu-Latn = ptu-Latn-ID
ptv = ptv-VU = ptv-Latn = ptv-Latn-VU
pua = pua-MX = pua-Latn = pua-Latn-MX
pub-Latn = pub-Latn-IN
pug-Latn = pug-Latn-BF
pui = pui-CO = pui-Latn = pui-Latn-CO
pum-Deva = pum-Deva-NP
puu = puu-GA = puu-Latn = puu-Latn-GA
pwa = pwa-PG = *pwa-Latn = pwa-Latn-PG
pwg = pwg-PG = pwg-Latn = pwg-Latn-PG
pwm-Latn = pwm-Latn-PH
pwn-Latn = pwn-Latn-TW
pwo-Mymr = pwo-Mymr-MM
pww-Thai = pww-Thai-TH
pxm = pxm-MX = pxm-Latn = pxm-Latn-MX
pyu-Hani = pyu-Hani-TW
pyu-Latn = pyu-Latn-TW
pyy-Latn = pyy-Latn-MM
pzn-Latn = pzn-Latn-MM
*qu = qu-Latn
*qu = *qu-PE = qu-Latn = qu-Latn-PE
qub = qub-PE = qub-Latn = qub-Latn-PE
quc = quc-GT = quc-Latn = quc-Latn-GT
qud = qud-EC = qud-Latn = qud-Latn-EC
quf = quf-PE = quf-Latn = quf-Latn-PE
qug = qug-EC = qug-Latn = qug-Latn-EC
quh = quh-BO = quh-Latn = quh-Latn-BO
quk = quk-PE = quk-Latn = quk-Latn-PE
qul = qul-BO = qul-Latn = qul-Latn-BO
qum = qum-GT = qum-Latn = qum-Latn-GT
qup = qup-PE = qup-Latn = qup-Latn-PE
qur = qur-PE = qur-Latn = qur-Latn-PE
qus = qus-AR = qus-Latn = qus-Latn-AR
quv = quv-GT = quv-Latn = quv-Latn-GT
quw = quw-EC = quw-Latn = quw-Latn-EC
quy = quy-PE = quy-Latn = quy-Latn-PE
quz = quz-PE = quz-Latn = quz-Latn-PE
qva = qva-PE = qva-Latn = qva-Latn-PE
qvc = qvc-PE = qvc-Latn = qvc-Latn-PE
qve = qve-PE = qve-Latn = qve-Latn-PE
qvh = qvh-PE = qvh-Latn = qvh-Latn-PE
qvi = qvi-EC = qvi-Latn = qvi-Latn-EC
qvj = qvj-EC = qvj-Latn = qvj-Latn-EC
qvm = qvm-PE = qvm-Latn = qvm-Latn-PE
qvn = qvn-PE = qvn-Latn = qvn-Latn-PE
qvo = qvo-PE = qvo-Latn = qvo-Latn-PE
qvs = qvs-PE = qvs-Latn = qvs-Latn-PE
qvw = qvw-PE = qvw-Latn = qvw-Latn-PE
qvz = qvz-EC = qvz-Latn = qvz-Latn-EC
qwa = qwa-PE = qwa-Latn = qwa-Latn-PE
qwh = qwh-PE = qwh-Latn = qwh-Latn-PE
qxh = qxh-PE = qxh-Latn = qxh-Latn-PE
qxl = qxl-EC = qxl-Latn = qxl-Latn-EC
qxn = qxn-PE = qxn-Latn = qxn-Latn-PE
qxo = qxo-PE = qxo-Latn = qxo-Latn-PE
qxp = qxp-PE = qxp-Latn = qxp-Latn-PE
qxq-Arab = qxq-Arab-IR
qxr = qxr-EC = qxr-Latn = qxr-Latn-EC
qxu = qxu-PE = qxu-Latn = qxu-Latn-PE
raa-Deva = raa-Deva-NP
rab-Deva = rab-Deva-NP
rad-Latn = rad-Latn-VN
raf-Deva = raf-Deva-NP
rag = rag-KE = rag-Latn = rag-Latn-KE
rah-Beng = rah-Beng-IN
rah-Latn = rah-Latn-IN
rai = rai-PG = *rai-Latn = rai-Latn-PG
raj = raj-IN = raj-Deva = raj-Deva-IN
raj-Latn = raj-Latn
ram = ram-BR = ram-Latn = ram-Latn-BR
rao = rao-PG = *rao-Latn = rao-Latn-PG
rap = rap-CL = rap-Latn = rap-Latn-CL
rar = rar-CK = rar-Latn = rar-Latn-CK
rav-Deva = rav-Deva-NP
raw-Latn = raw-Latn-MM
ray-Latn = ray-Latn-PF
rbb-Mymr = rbb-Mymr-MM
rcf = rcf-RE = rcf-Latn = rcf-Latn-RE
rdb-Arab = rdb-Arab-IR
rej = rej-ID = rej-Latn = rej-Latn-ID
rej-Rjng = rej-Rjng-ID
rel = rel-KE = *rel-Latn = rel-Latn-KE
ren-Latn = ren-Latn-VN
*res-Latn = res-Latn-NG
rgn = rgn-IT = rgn-Latn = rgn-Latn-IT
rgr = rgr-PE = rgr-Latn = rgr-Latn-PE
rgu-Latn = rgu-Latn-ID
*rhg-Arab = rhg-Arab-MM
rhg-Latn = rhg-Latn-MM
rhg-Qabp = rhg-Qabp-MM
ria = ria-IN = ria-Latn = ria-Latn-IN
rif = rif-MA = rif-Tfng = rif-Tfng-MA
rif-Arab = rif-Arab-MA
rif-Latn = rif-Latn-MA
rif-NL = rif-Latn-NL
ril-Latn = ril-Latn-MM
rim = rim-TZ = rim-Latn = rim-Latn-TZ
rji-Deva = rji-Deva-NP
rjs = rjs-NP = rjs-Deva = rjs-Deva-NP
rkb = rkb-BR = rkb-Latn = rkb-Latn-BR
rkh-Latn = rkh-Latn-CK
rki-Mymr = rki-Mymr-MM
rkm-Latn = rkm-Latn-BF
rkt = rkt-BD = rkt-Beng = rkt-Beng-BD
*rm = *rm-CH = rm-Latn = rm-Latn-CH
*rm = *rm-CH = rm-Latn = rm-Latn-CH
rmc-Latn = rmc-Latn-SK
rme-Latn = rme-Latn-GB
rmf = rmf-FI = rmf-Latn = rmf-Latn-FI
rml-Cyrl = rml-Cyrl-BY
rml-Latn = rml-Latn-PL
rmn-Cyrl = rmn-Cyrl-RS
rmo = rmo-CH = rmo-Latn = rmo-Latn-CH
rmp = rmp-PG = rmp-Latn = rmp-Latn-PG
rmq-Latn = rmq-Latn-ES
rmt = rmt-IR = rmt-Arab = rmt-Arab-IR
rmu = rmu-SE = rmu-Latn = rmu-Latn-SE
rmy-Cyrl = rmy-Cyrl-RO
rmy-Latn = rmy-Latn-RO
rmz-Mymr = rmz-Mymr-IN
*rn = *rn-BI = rn-Latn = rn-Latn-BI
*rn = *rn-BI = rn-Latn = rn-Latn-BI
rn-Brai = rn-Brai-BI
rnd-Latn = rnd-Latn-CD
rng = rng-MZ = rng-Latn = rng-Latn-MZ
rnl-Latn = rnl-Latn-IN
*ro = ro-Latn
*ro = *ro-RO = ro-Latn = ro-Latn-RO
ro-Brai = ro-Brai-RO
ro-Cyrl = ro-Cyrl-RO
*ro-MD = ro-Latn-MD
rob = rob-ID = rob-Latn = rob-Latn-ID
*rof = *rof-TZ = rof-Latn = rof-Latn-TZ
rog-Latn = rog-Latn-VN
rol-Latn = rol-Latn-PH
rom-Cyrl = rom-Cyrl-RO
rom-Latn = rom-Latn-RO
roo = roo-PG = *roo-Latn = roo-Latn-PG
rop = rop-AU = rop-Latn = rop-Latn-AU
rro = rro-PG = *rro-Latn = rro-Latn-PG
rtm = rtm-FJ = rtm-Latn = rtm-Latn-FJ
*ru = ru-Cyrl
*ru = *ru-RU = ru-Cyrl = ru-Cyrl-RU
ru-Brai = ru-Brai-RU
*ru-KZ = ru-Cyrl-KZ
rub = rub-UG = rub-Latn = rub-Latn-UG
ruc = ruc-UG = ruc-Latn = ruc-Latn-UG
rue = rue-UA = rue-Cyrl = rue-Cyrl-UA
rue-Latn = rue-Latn-SK
ruf = ruf-TZ = ruf-Latn = ruf-Latn-TZ
rug = rug-SB = rug-Latn = rug-Latn-SB
ruk-Latn = ruk-Latn-NG
rup-Grek = rup-Grek-GR
rup-Latn = rup-Latn-GR
ruq-Latn = ruq-Latn-GR
rut-Cyrl = rut-Cyrl-RU
ruu-Latn = ruu-Latn-MY
*rw = rw-Latn
*rw = *rw-RW = rw-Latn = rw-Latn-RW
rw-Brai = rw-Brai-RW
*rwk = *rwk-TZ = rwk-Latn = rwk-Latn-TZ
rwm = rwm-UG = rwm-Latn = rwm-Latn-UG
rwo = rwo-PG = *rwo-Latn = rwo-Latn-PG
rwr-Deva = rwr-Deva-IN
ryu = ryu-JP = ryu-Kana = ryu-Kana-JP
sa = sa-IN = *sa-Deva = sa-Deva-IN
sa-Gran = sa-Gran-IN
sa-Mymr = sa-Mymr-IN
sa-Newa = sa-Newa-IN
sa-Shrd = sa-Shrd-IN
sa-Sidd = sa-Sidd-IN
sa-Sinh = sa-Sinh-IN
saa-Latn = saa-Latn-TD
sab = sab-PA = sab-Latn = sab-Latn-PA
sac-Latn = sac-Latn-US
sad = sad-TZ = sad-Latn = sad-Latn-TZ
saf = saf-GH = *saf-Latn = saf-Latn-GH
*sah = *sah-RU = sah-Cyrl = sah-Cyrl-RU
saj-Latn = saj-Latn-ID
sam-Hebr = sam-Hebr-PS
sam-Samr = sam-Samr-PS
*saq = *saq-KE = saq-Latn = saq-Latn-KE
sas = sas-ID = sas-Latn = sas-Latn-ID
sas-Bali = sas-Bali-ID
sat = sat-IN = sat-Latn = sat-Latn-IN
sat-Beng = sat-Beng-IN
sat-Deva = sat-Deva-NP
sat-Olck = sat-Olck-IN
sat-Orya = sat-Orya-IN
*sav-Arab = sav-Arab-SN
sav-Latn = sav-Latn-SN
saw-Latn = saw-Latn-ID
say-Latn = say-Latn-NG
saz = saz-IN = saz-Saur = saz-Saur-IN
saz-Deva = saz-Deva-IN
saz-Taml = saz-Taml-IN
saz-Telu = saz-Telu-IN
*sba-Latn = sba-Latn-TD
sbb = sbb-SB = sbb-Latn = sbb-Latn-SB
sbd-Latn = sbd-Latn-BF
sbe = sbe-PG = *sbe-Latn = sbe-Latn-PG
sbk = sbk-TZ = sbk-Latn = sbk-Latn-TZ
sbl-Latn = sbl-Latn-PH
*sbp = *sbp-TZ = sbp-Latn = sbp-Latn-TZ
sbu-Deva = sbu-Deva-IN
sbu-Tibt = sbu-Tibt-IN
sby = sby-ZM = sby-Latn = sby-Latn-ZM
sc = sc-IT = sc-Latn = sc-Latn-IT
sce-Arab = sce-Arab-CN
sce-Latn = sce-Latn-CN
sch-Latn = sch-Latn-IN
sci-Latn = sci-Latn-LK
sck = sck-IN = sck-Deva = sck-Deva-IN
sck-Beng = sck-Beng-IN
scl = scl-PK = *scl-Arab = scl-Arab-PK
scn = scn-IT = scn-Latn = scn-Latn-IT
sco = sco-GB = sco-Latn = sco-Latn-GB
scp-Deva = scp-Deva-NP
scs = scs-CA = scs-Latn = scs-Latn-CA
scs-Cans = scs-Cans-CA
sd = sd-PK = *sd-Arab = sd-Arab-PK
sd-Deva = sd-Deva-IN
sd-Guru = sd-Guru-IN
sd-Khoj = sd-Khoj-IN
sd-Sind = sd-Sind-IN
sda-Latn = sda-Latn-ID
sdc = sdc-IT = sdc-Latn = sdc-Latn-IT
sdh = sdh-IR = sdh-Arab = sdh-Arab-IR
sdk = sdk-PG = sdk-Latn = sdk-Latn-PG
sdm-Latn = sdm-Latn-ID
sdn-Latn = sdn-Latn-IT
sdo-Latn = sdo-Latn-MY
sdr-Beng = sdr-Beng-BD
sdr-Latn = sdr-Latn-BD
*se = *se-NO = se-Latn = se-Latn-NO
se-Cyrl = se-Cyrl-NO
sea-Latn = sea-Latn-MY
sed-Latn = sed-Latn-VN
see-Latn = see-Latn-US
sef = sef-CI = *sef-Latn = sef-Latn-CI
*seh = *seh-MZ = seh-Latn = seh-Latn-MZ
sei = sei-MX = sei-Latn = sei-Latn-MX
sek-Cans = sek-Cans-CA
sek-Latn = sek-Latn-CA
sel-Cyrl = sel-Cyrl-RU
sep-Latn = sep-Latn-BF
*ses = *ses-ML = ses-Latn = ses-Latn-ML
set-Latn = set-Latn-ID
sev-Latn = sev-Latn-CI
sey = sey-EC = sey-Latn = sey-Latn-EC
sez-Latn = sez-Latn-MM
sfm-Plrd = sfm-Plrd-CN
sfw-Latn = sfw-Latn-GH
*sg = *sg-CF = sg-Latn = sg-Latn-CF
*sg = *sg-CF = sg-Latn = sg-Latn-CF
sga = sga-IE = sga-Ogam = sga-Ogam-IE
sga-Latn = sga-Latn-IE
sgb-Latn = sgb-Latn-PH
sgc = sgc-KE = sgc-Latn = sgc-Latn-KE
sgh-Arab = sgh-Arab-AF
sgh-Cyrl = sgh-Cyrl-TJ
sgh-Latn = sgh-Latn-TJ
sgp-Latn = sgp-Latn-IN
sgr-Arab = sgr-Arab-IR
sgs = sgs-LT = sgs-Latn = sgs-Latn-LT
*sgw-Ethi = sgw-Ethi-ET
sgz = sgz-PG = *sgz-Latn = sgz-Latn-PG
sh-Latn = sh-Latn-RS
shb = shb-BR = shb-Latn = shb-Latn-BR
*she-Latn = she-Latn-ET
shg = shg-BW = shg-Latn = shg-Latn-BW
shh-Latn = shh-Latn-US
*shi = shi-MA = *shi-Tfng = *shi-Tfng-MA
shi-Arab = shi-Arab-MA
*shi-Latn = *shi-Latn-MA
shj-Latn = shj-Latn-SD
*shk-Latn = shk-Latn-SS
shm-Arab = shm-Arab-IR
shn = shn-MM = *shn-Mymr = shn-Mymr-MM
shn-Thai = shn-Thai-TH
shp = shp-PE = shp-Latn = shp-Latn-PE
shr-Latn = shr-Latn-CD
*shu-Arab = shu-Arab-TD
shu-Latn = shu-Latn-TD
shw-Latn = shw-Latn-SD
shy-Arab = shy-Arab-DZ
shy-Latn = shy-Latn-DZ
shy-Tfng = shy-Tfng-DZ
shz-Latn = shz-Latn-ML
*si = *si-LK = si-Sinh = si-Sinh-LK
*si = *si-LK = si-Sinh = si-Sinh-LK
si-Brai = si-Brai-LK
*sid = sid-ET = sid-Latn = sid-Latn-ET
sid-Ethi = sid-Ethi-ET
sie = sie-ZM = sie-Latn = sie-Latn-ZM
sif-Latn = sif-Latn-BF
*sig-Latn = sig-Latn-GH
*sil-Latn = sil-Latn-GH
sim = sim-PG = *sim-Latn = sim-Latn-PG
sip-Tibt = sip-Tibt-IN
siw = siw-PG = siw-Latn = siw-Latn-PG
six = six-PG = six-Latn = six-Latn-PG
sja = sja-CO = sja-Latn = sja-Latn-CO
sjd-Cyrl = sjd-Cyrl-RU
sjl-Latn = sjl-Latn-IN
sjm-Latn = sjm-Latn-PH
sjo-Cyrl = sjo-Cyrl-CN
sjo-Latn = sjo-Latn-CN
sjo-Mong-x-manchu = sjo-Mong-CN-x-manchu
sjo-Mong-x-sibe = sjo-Mong-CN-x-sibe
sjp-Deva = sjp-Deva-IN
sjr = sjr-PG = *sjr-Latn = sjr-Latn-PG
sju = sju-SE = sju-Latn = sju-Latn-SE
sjw-Latn = sjw-Latn-US
*sk = sk-Latn
*sk = *sk-SK = sk-Latn = sk-Latn-SK
sk-Brai = sk-Brai-SK
skc = skc-PG = *skc-Latn = skc-Latn-PG
skm = skm-PG = skm-Latn = skm-Latn-PG
skn-Latn = skn-Latn-PH
skr = skr-PK = *skr-Arab = skr-Arab-PK
skr-Deva = skr-Deva-PK
skr-Guru = skr-Guru-PK
skr-Khoj = skr-Khoj-PK
skr-Mult = skr-Mult-PK
sks = sks-PG = *sks-Latn = sks-Latn-PG
skt-Latn = skt-Latn-CD
sku = sku-VU = sku-Latn = sku-Latn-VU
skv-Latn = skv-Latn-ID
skx-Latn = skx-Latn-ID
*sl = sl-Latn
*sl = *sl-SI = sl-Latn = sl-Latn-SI
sl-Brai = sl-Brai-SI
slc = slc-CO = slc-Latn = slc-Latn-CO
*sld-Latn = sld-Latn-BF
sli = sli-PL = sli-Latn = sli-Latn-PL
sll = sll-PG = *sll-Latn = sll-Latn-PG
slm-Latn = slm-Latn-PH
slu-Latn = slu-Latn-ID
slx-Latn = slx-Latn-CD
sly = sly-ID = sly-Latn = sly-Latn-ID
sm = sm-Latn
sm = sm-WS = sm-Latn = sm-Latn-WS
sm-AS = sm-Latn-AS
sma = sma-SE = sma-Latn = sma-Latn-SE
smb = smb-PG = smb-Latn = smb-Latn-PG
smg = smg-PG = smg-Latn = smg-Latn-PG
smh-Yiii-x-traditional = smh-Yiii-CN-x-traditional
smj = smj-SE = smj-Latn = smj-Latn-SE
smk-Latn = smk-Latn-PH
sml-Latn = sml-Latn-PH
*smn = *smn-FI = smn-Latn = smn-Latn-FI
smp = smp-IL = smp-Samr = smp-Samr-IL
smp-Arab = smp-Arab-PS
smp-Hebr = smp-Hebr-PS
smq = smq-PG = *smq-Latn = smq-Latn-PG
sms = sms-FI = sms-Latn = sms-Latn-FI
smt-Latn = smt-Latn-IN
smx-Latn = smx-Latn-CD
smy-Arab = smy-Arab-IR
*sn = *sn-ZW = sn-Latn = sn-Latn-ZW
sn-Brai = sn-Brai-ZW
snc = snc-PG = *snc-Latn = snc-Latn-PG
sne-Latn = sne-Latn-MY
snf-Latn = snf-Latn-SN
sng-Brai = sng-Brai-CD
sng-Latn = sng-Latn-CD
snk = snk-ML = *snk-Latn = snk-Latn-ML
*snk-Arab = snk-Arab-ML
snl-Latn = snl-Latn-PH
snn = snn-CO = snn-Latn = snn-Latn-CO
snp = snp-PG = *snp-Latn = snp-Latn-PG
snq-Latn = snq-Latn-GA
sns = sns-VU = sns-Latn = sns-Latn-VU
snv-Latn = snv-Latn-MY
snw-Latn = snw-Latn-GH
snx = snx-PG = *snx-Latn = snx-Latn-PG
sny = sny-PG = *sny-Latn = sny-Latn-PG
snz = snz-PG = snz-Latn = snz-Latn-PG
*so = so-Latn
*so = *so-SO = so-Latn = so-Latn-SO
*so-Arab = so-Arab-SO
so-Osma = so-Osma-SO
soa-Tavt = soa-Tavt-TH
soa-Thai = soa-Thai-TH
sob-Latn = sob-Latn-ID
soc-Latn = soc-Latn-CD
*sok-Latn = sok-Latn-TD
sol = sol-PG = sol-Latn = sol-Latn-PG
sop-Latn = sop-Latn-CD
soq = soq-PG = *soq-Latn = soq-Latn-PG
sor-Latn = sor-Latn-TD
sou = sou-TH = sou-Thai = sou-Thai-TH
sov-Latn = sov-Latn-PW
sox-Latn = sox-Latn-CM
*soy-Latn = soy-Latn-BJ
soz = soz-TZ = soz-Latn = soz-Latn-TZ
spd = spd-PG = *spd-Latn = spd-Latn-PG
spl = spl-PG = *spl-Latn = spl-Latn-PG
spm = spm-PG = spm-Latn = spm-Latn-PG
spn = spn-PY = spn-Latn = spn-Latn-PY
spp-Latn = spp-Latn-ML
sps = sps-PG = *sps-Latn = sps-Latn-PG
spv-Orya = spv-Orya-IN
spy = spy-KE = *spy-Latn = spy-Latn-KE
*sq = *sq-AL = sq-Latn = sq-Latn-AL
*sq = sq-Latn
sq-Elba = sq-Elba-AL
*sq-MK = sq-Latn-MK
*sq-XK = sq-Latn-XK
sqt-Arab = sqt-Arab-YE
sqt-Latn = sqt-Latn-YE
squ-Latn = squ-Latn-CA
*sr = sr-RS = *sr-Cyrl = *sr-Cyrl-RS
sr-BA = *sr-Cyrl-BA
sr-Brai = sr-Brai-RS
*sr-Latn = *sr-Latn-RS
sr-ME = *sr-Latn-ME
sr-RO = sr-Latn-RO
sr-RU = sr-Latn-RU
sr-TR = sr-Latn-TR
sr-XK = *sr-Cyrl-XK
srb = srb-IN = srb-Sora = srb-Sora-IN
srb-Latn = srb-Latn-IN
srb-Orya = srb-Orya-IN
srb-Telu = srb-Telu-IN
src-Latn = src-Latn-IT
sre-Latn = sre-Latn-ID
sri = sri-CO = sri-Latn = sri-Latn-CO
srl-Latn = srl-Latn-ID
srm = srm-SR = srm-Latn = srm-Latn-SR
srn = srn-SR = *srn-Latn = srn-Latn-SR
sro-Latn = sro-Latn-IT
srq = srq-BO = srq-Latn = srq-Latn-BO
srr = srr-SN = *srr-Latn = srr-Latn-SN
*srr-Arab = srr-Arab-SN
sru = sru-BR = sru-Latn = sru-Latn-BR
srx = srx-IN = srx-Deva = srx-Deva-IN
srx-Takr = srx-Takr-IN
sry = sry-PG = sry-Latn = sry-Latn-PG
*ss = ss-Latn
*ss = *ss-ZA = ss-Latn = ss-Latn-ZA
ssb-Latn = ssb-Latn-PH
ssc = ssc-TZ = ssc-Latn = ssc-Latn-TZ
ssd = ssd-PG = *ssd-Latn = ssd-Latn-PG
sse-Arab = sse-Arab-PH
sse-Latn = sse-Latn-PH
ssf-Latn = ssf-Latn-TW
ssg = ssg-PG = *ssg-Latn = ssg-Latn-PG
ssj = ssj-PG = ssj-Latn = ssj-Latn-PG
ssl-Latn = ssl-Latn-GH
sso = sso-PG = sso-Latn = sso-Latn-PG
sss-Thai = sss-Thai-LA
sst = sst-PG = sst-Latn = sst-Latn-PG
ssx = ssx-PG = ssx-Latn = ssx-Latn-PG
*ssy = *ssy-ER = ssy-Latn = ssy-Latn-ER
ssy-Ethi = ssy-Ethi-ET
ssz = ssz-PG = ssz-Latn = ssz-Latn-PG
*st = st-Latn
*st = st-ZA = st-Latn = st-Latn-ZA
*st-LS = st-Latn-LS
stb-Latn = stb-Latn-PH
ste-Latn = ste-Latn-ID
sti-Latn = sti-Latn-VN
stk = stk-PG = *stk-Latn = stk-Latn-PG
stn = stn-SB = stn-Latn = stn-Latn-SB
sto-Latn = sto-Latn-CA
stp = stp-MX = stp-Latn = stp-Latn-MX
stq = stq-DE = stq-Latn = stq-Latn-DE
stt-Latn = stt-Latn-VN
stv-Ethi = stv-Ethi-ET
stw-Latn = stw-Latn-FM
su = su-ID = su-Latn = su-Latn-ID
su-Arab = su-Arab-ID
*su-Java = su-Java-ID
*su-Sund = su-Sund-ID
sua = sua-PG = *sua-Latn = sua-Latn-PG
sub-Latn = sub-Latn-CD
suc-Latn = suc-Latn-PH
sue = sue-PG = *sue-Latn = sue-Latn-PG
sui = sui-PG = sui-Latn = sui-Latn-PG
suk = suk-TZ = suk-Latn = suk-Latn-TZ
*suq-Ethi = suq-Ethi-ET
*suq-Latn = suq-Latn-ET
*sur-Latn = sur-Latn-NG
sus = sus-GN = *sus-Latn = sus-Latn-GN
*sus-Arab = sus-Arab-GN
suv-Beng = suv-Beng-IN
suv-Deva = suv-Deva-IN
suv-Latn = suv-Latn-IN
suy = suy-BR = suy-Latn = suy-Latn-BR
suz-Deva = suz-Deva-NP
*sv = sv-Latn
*sv = *sv-SE = sv-Latn = sv-Latn-SE
*sv-AX = sv-Latn-AX
sv-Brai = sv-Brai-SE
sva-Cyrl = sva-Cyrl-GE
sva-Geor = sva-Geor-GE
sva-Latn = sva-Latn-GE
svc = svc-VC = svc-Latn = svc-Latn-VC
svm-Latn = svm-Latn-IT
*sw = sw-Latn
*sw = *sw-TZ = sw-Latn = sw-Latn-TZ
*sw-Arab = sw-Arab-TZ
*sw-CD = sw-Latn-CD
*sw-KE = sw-Latn-KE
*sw-UG = sw-Latn-UG
swb = swb-YT = swb-Arab = swb-Arab-YT
swb-Latn = swb-Latn-YT
*swc = swc-CD = swc-Latn = swc-Latn-CD
swg = swg-DE = swg-Latn = swg-Latn-DE
swh = swh-TZ = swh-Latn = swh-Latn-TZ
swh-Brai = swh-Brai-TZ
swi-Hani = swi-Hani-CN
swj-Latn = swj-Latn-GA
swk-Latn = swk-Latn-MW
swo = swo-BR = swo-Latn = swo-Latn-BR
swp = swp-PG = *swp-Latn = swp-Latn-PG
swv = swv-IN = swv-Deva = swv-Deva-IN
sxb = sxb-KE = sxb-Latn = sxb-Latn-KE
sxn = sxn-ID = sxn-Latn = sxn-Latn-ID
sxu-Latn = sxu-Latn-DE
*sxw-Latn = sxw-Latn-BJ
syb-Latn = syb-Latn-PH
syc-Syrc = syc-Syrc-TR
syi = syi-GQ
syl = syl-BD = syl-Beng = syl-Beng-BD
syl-Latn = syl-Latn-BD
*syl-Sylo = syl-Sylo-BD
syn-Syrc = syn-Syrc-IR
*syr = syr-IQ = syr-Syrc = syr-Syrc-IQ
syw-Deva = syw-Deva-NP
szb-Latn = szb-Latn-ID
szg-Latn = szg-Latn-CD
szl = szl-PL = szl-Latn = szl-Latn-PL
szv-Latn = szv-Latn-CM
szw-Latn = szw-Latn-ID
*ta = *ta-IN = ta-Taml = ta-Taml-IN
*ta = ta-Taml
ta-Brai = ta-Brai-IN
tab = tab-RU = tab-Cyrl = tab-Cyrl-RU
tac = tac-MX = tac-Latn = tac-Latn-MX
taj = taj-NP = taj-Deva = taj-Deva-NP
taj-Tibt-x-tamhig = taj-Tibt-BT-x-tamhig
*tal-Latn = tal-Latn-NG
*tan-Latn = tan-Latn-NG
tao-Latn = tao-Latn-TW
tap-Latn = tap-Latn-CD
*taq-Latn = taq-Latn-ML
taq-Tfng = taq-Tfng-ML
tar = tar-MX = tar-Latn = tar-Latn-MX
tau-Latn = tau-Latn-US
tav = tav-CO = tav-Latn = tav-Latn-CO
taw = taw-PG = taw-Latn = taw-Latn-PG
tay-Hans = tay-Hans-TW
tay-Hant = tay-Hant-TW
tay-Latn = tay-Latn-TW
taz-Latn = taz-Latn-SD
tbc = tbc-PG = *tbc-Latn = tbc-Latn-PG
tbd = tbd-PG = *tbd-Latn = tbd-Latn-PG
tbf = tbf-PG = *tbf-Latn = tbf-Latn-PG
tbg = tbg-PG = *tbg-Latn = tbg-Latn-PG
tbi-Latn = tbi-Latn-SD
tbj = tbj-PG = tbj-Latn = tbj-Latn-PG
tbk-Latn = tbk-Latn-PH
tbk-Tagb = tbk-Tagb-PH
tbl-Latn = tbl-Latn-PH
tbo = tbo-PG = *tbo-Latn = tbo-Latn-PG
tbt-Latn = tbt-Latn-CD
tbv = tbv-PG = tbv-Latn = tbv-Latn-PG
tbw = tbw-PH = tbw-Latn = tbw-Latn-PH
tbw-Tagb = tbw-Tagb-PH
tbx = tbx-PG = tbx-Latn = tbx-Latn-PG
tby-Latn = tby-Latn-ID
*tbz-Latn = tbz-Latn-BJ
tca = tca-BR = tca-Latn = tca-Latn-BR
tcb-Latn = tcb-Latn-US
tcc = tcc-TZ = tcc-Latn = tcc-Latn-TZ
tcf = tcf-MX = tcf-Latn = tcf-Latn-MX
tci = tci-PG = *tci-Latn = tci-Latn-PG
tcp-Latn = tcp-Latn-MM
tcs = tcs-AU = tcs-Latn = tcs-Latn-AU
tcw = tcw-MX = tcw-Latn = tcw-Latn-MX
tcx-Taml = tcx-Taml-IN
tcy = tcy-IN = tcy-Knda = tcy-Knda-IN
tcy-x-in-tulu = tcy-x-in-tulu = tcy-x-in-tulu = tcy-x-in-tulu
tcz-Latn = tcz-Latn-IN
tda-Arab = tda-Arab-NE
tda-Latn = tda-Latn-NE
tda-Tfng = tda-Tfng-NE
tdb-Beng = tdb-Beng-IN
tdb-Deva = tdb-Deva-IN
tdb-Kthi = tdb-Kthi-IN
tdc = tdc-CO = tdc-Latn = tdc-Latn-CO
tdd = tdd-CN = *tdd-Tale = tdd-Tale-CN
tdg = tdg-NP = tdg-Deva = tdg-Deva-NP
tdg-Tibt = tdg-Tibt-NP
tdh = tdh-NP = tdh-Deva = tdh-Deva-NP
tdn-Latn = tdn-Latn-ID
tdt-Latn = tdt-Latn-TL
tdx = tdx-MG = tdx-Latn = tdx-Latn-MG
*te = *te-IN = te-Telu = te-Telu-IN
*te = *te-IN = te-Telu = te-Telu-IN
te-Brai = te-Brai-IN
*ted-Latn = ted-Latn-CI
tee = tee-MX = tee-Latn = tee-Latn-MX
teg-Latn = teg-Latn-GA
tek-Latn = tek-Latn-CD
*tem = tem-SL = tem-Latn = tem-Latn-SL
*tem = tem-SL = tem-Latn = tem-Latn-SL
*teo = *teo-UG = teo-Latn = teo-Latn-UG
teq-Latn = teq-Latn-SD
ter = ter-BR = ter-Latn = ter-Latn-BR
tes-Java = tes-Java-ID
tet = tet-TL = tet-Latn = tet-Latn-TL
tew-Latn = tew-Latn-US
tex-Latn = tex-Latn-SS
tey-Latn = tey-Latn-SD
*tfi-Latn = tfi-Latn-BJ
tfr = tfr-PA = tfr-Latn = tfr-Latn-PA
*tg = tg-PK = tg-Arab = tg-Arab-PK
*tg = tg-TJ = tg-Cyrl = tg-Cyrl-TJ
tg-Hebr = tg-Hebr-TJ
tg-Latn = tg-Latn-TJ
tga = tga-KE = tga-Latn = tga-Latn-KE
tgb-Latn = tgb-Latn-MY
tgc = tgc-PG = *tgc-Latn = tgc-Latn-PG
tgo = tgo-PG = *tgo-Latn = tgo-Latn-PG
tgp = tgp-VU = tgp-Latn = tgp-Latn-VU
tgs = tgs-VU = tgs-Latn = tgs-Latn-VU
tgu = tgu-PG = *tgu-Latn = tgu-Latn-PG
tgw-Latn = tgw-Latn-CI
*th = *th-TH = th-Thai = th-Thai-TH
*th = *th-TH = th-Thai = th-Thai-TH
th-Brai = th-Brai-TH
thd = thd-AU = thd-Latn = thd-Latn-AU
the-Deva = the-Deva-NP
thf-Deva = thf-Deva-NP
thk = thk-KE = thk-Latn = thk-Latn-KE
thl = thl-NP = thl-Deva = thl-Deva-NP
thq = thq-NP = thq-Deva = thq-Deva-NP
thr = thr-NP = thr-Deva = thr-Deva-NP
ths-Deva = ths-Deva-NP
thu-Latn = thu-Latn-SS
thv-Arab = thv-Arab-DZ
thv-Tfng = thv-Tfng-DZ
thz-Latn = thz-Latn-NE
thz-Tfng = thz-Tfng-NE
*ti = *ti-ET = ti-Ethi = ti-Ethi-ET
*ti = ti-Ethi
*ti-ER = ti-Ethi-ER
tic-Latn = tic-Latn-SD
tif = tif-PG = *tif-Latn = tif-Latn-PG
*tig = tig-ER = tig-Ethi = tig-Ethi-ER
tih-Latn = tih-Latn-MY
tii-Latn = tii-Latn-CD
tij-Deva = tij-Deva-NP
*tik-Latn = tik-Latn-CM
tim = tim-PG = *tim-Latn = tim-Latn-PG
tio = tio-PG = *tio-Latn = tio-Latn-PG
tiu-Latn = tiu-Latn-PH
tiv = tiv-NG = *tiv-Latn = tiv-Latn-NG
tiw = tiw-AU = tiw-Latn = tiw-Latn-AU
tix-Latn = tix-Latn-US
tiy-Latn = tiy-Latn-PH
tjl-Mymr = tjl-Mymr-MM
*tk = *tk-TM = tk-Latn = tk-Latn-TM
tk-AF = tk-Latn-AF
tk-Arab = tk-Arab-AF
tk-Cyrl = tk-Cyrl-TM
tk-IR = tk-Latn-IR
tkb-Deva = tkb-Deva-IN
tkd-Latn = tkd-Latn-TL
tke-Latn = tke-Latn-MZ
tkg = tkg-MG = tkg-Latn = tkg-Latn-MG
tkl = tkl-TK = tkl-Latn = tkl-Latn-TK
tkl = tkl-TK = tkl-Latn = tkl-Latn-TK
tkp = tkp-SB = tkp-Latn = tkp-Latn-SB
tkr = tkr-AZ = tkr-Latn = tkr-Latn-AZ
tkr-Cyrl = tkr-Cyrl-RU
tks-Arab = tks-Arab-IR
tkt = tkt-NP = tkt-Deva = tkt-Deva-NP
tku = tku-MX = tku-Latn = tku-Latn-MX
tkw = tkw-SB = tkw-Latn = tkw-Latn-SB
tl = tl-Latn
tl = tl-PH = tl-Latn = tl-Latn-PH
tl-Brai = tl-Brai-PH
tl-Tglg = tl-Tglg-PH
tla = tla-MX = tla-Latn = tla-Latn-MX
tlb-Latn = tlb-Latn-ID
tld-Latn = tld-Latn-ID
tlf = tlf-PG = *tlf-Latn = tlf-Latn-PG
tli-Cyrl = tli-Cyrl-US
tli-Latn = tli-Latn-US
tlj = tlj-UG = tlj-Latn = tlj-Latn-UG
tll-Latn = tll-Latn-CD
tlm = tlm-VU = tlm-Latn = tlm-Latn-VU
tlp = tlp-MX = tlp-Latn = tlp-Latn-MX
tlq-Latn = tlq-Latn-MM
tlx = tlx-PG = *tlx-Latn = tlx-Latn-PG
tly = tly-AZ = tly-Latn = tly-Latn-AZ
tly-Arab = tly-Arab-AZ
tly-Cyrl = tly-Cyrl-AZ
tmc-Latn = tmc-Latn-TD
tmd = tmd-PG = tmd-Latn = tmd-Latn-PG
tmh = tmh-Latn
tmh = tmh-NE = tmh-Latn = tmh-Latn-NE
tmk-Deva = tmk-Deva-NP
tmu-Latn = tmu-Latn-ID
tmy = tmy-PG = *tmy-Latn = tmy-Latn-PG
*tn = tn-Latn
*tn = *tn-ZA = tn-Latn = tn-Latn-ZA
tna = tna-BO = tna-Latn = tna-Latn-BO
tnc = tnc-CO = tnc-Latn = tnc-Latn-CO
tng-Latn = tng-Latn-TD
tnh = tnh-PG = *tnh-Latn = tnh-Latn-PG
tnk = tnk-VU = tnk-Latn = tnk-Latn-VU
tnl = tnl-VU = tnl-Latn = tnl-Latn-VU
tnm-Latn = tnm-Latn-ID
tnn = tnn-VU = tnn-Latn = tnn-Latn-VU
tnp = tnp-VU = tnp-Latn = tnp-Latn-VU
tnr-Latn = tnr-Latn-SN
tnt-Latn = tnt-Latn-ID
tnv-Cakm = tnv-Cakm-BD
*to = *to-TO = to-Latn = to-Latn-TO
*to = *to-TO = to-Latn = to-Latn-TO
tob = tob-AR = tob-Latn = tob-Latn-AR
toc = toc-MX = toc-Latn = toc-Latn-MX
tod-Latn = tod-Latn-GN
tof = tof-PG = *tof-Latn = tof-Latn-PG
tog = tog-MW = tog-Latn = tog-Latn-MW
toh-Latn = toh-Latn-MZ
toi = toi-ZM = toi-Latn = toi-Latn-ZM
toj = toj-MX = toj-Latn = toj-Latn-MX
tom-Latn = tom-Latn-ID
too = too-MX = too-Latn = too-Latn-MX
top = top-MX = top-Latn = top-Latn-MX
*toq-Latn = toq-Latn-SS
tos = tos-MX = tos-Latn = tos-Latn-MX
tow-Latn = tow-Latn-US
tox-Latn = tox-Latn-PW
tpa = tpa-PG = tpa-Latn = tpa-Latn-PG
tpc = tpc-MX = tpc-Latn = tpc-Latn-MX
tpe-Beng = tpe-Beng-BD
tpe-Latn = tpe-Latn-BD
tpg-Latn = tpg-Latn-ID
tpi = tpi-PG = tpi-Latn = tpi-Latn-PG
tpi = tpi-PG = tpi-Latn = tpi-Latn-PG
tpl = tpl-MX = tpl-Latn = tpl-Latn-MX
*tpm-Latn = tpm-Latn-GH
tpp = tpp-MX = tpp-Latn = tpp-Latn-MX
tpt = tpt-MX = tpt-Latn = tpt-Latn-MX
tpu-Khmr = tpu-Khmr-KH
tpx = tpx-MX = tpx-Latn = tpx-Latn-MX
tpz = tpz-PG = *tpz-Latn = tpz-Latn-PG
tqb = tqb-BR = tqb-Latn = tqb-Latn-BR
tql = tql-VU = tql-Latn = tql-Latn-VU
tqo = tqo-PG = *tqo-Latn = tqo-Latn-PG
tqp = tqp-PG = tqp-Latn = tqp-Latn-PG
tqt = tqt-MX = tqt-Latn = tqt-Latn-MX
*tr = tr-Latn
*tr = *tr-TR = tr-Latn = tr-Latn-TR
tr-Arab = tr-Arab-TR
tr-Brai = tr-Brai-TR
*tr-CY = tr-Latn-CY
tr-Grek = tr-Grek-TR
trc = trc-MX = trc-Latn = trc-Latn-MX
trg-Hebr = trg-Hebr-IL
tri = tri-SR = tri-Latn = tri-Latn-SR
trn = trn-BO = trn-Latn = trn-Latn-BO
tro-Latn = tro-Latn-IN
trp-Beng = trp-Beng-IN
trp-Latn = trp-Latn-IN
trq = trq-MX = trq-Latn = trq-Latn-MX
trr = trr-PE = trr-Latn = trr-Latn-PE
trs = trs-MX = trs-Latn = trs-Latn-MX
tru = tru-TR = tru-Latn = tru-Latn-TR
tru-Syrc = tru-Syrc-TR
*trv = trv-TW = trv-Latn = trv-Latn-TW
trw = trw-PK = *trw-Arab = trw-Arab-PK
try-Latn = try-Latn-IN
*ts = ts-Latn
*ts = *ts-ZA = ts-Latn = ts-Latn-ZA
ts-Brai = ts-Brai-ZA
tsc-Latn = tsc-Latn-MZ
tsd = tsd-GR = tsd-Grek = tsd-Grek-GR
tsf = tsf-NP = tsf-Deva = tsf-Deva-NP
tsg = tsg-PH = tsg-Latn = tsg-Latn-PH
tsg-Arab = tsg-Arab-PH
tsi-Latn = tsi-Latn-CA
tsj = tsj-BT = tsj-Tibt = tsj-Tibt-BT
tsr = tsr-VU = tsr-Latn = tsr-Latn-VU
tsu-Latn = tsu-Latn-TW
tsv-Latn = tsv-Latn-GA
*tsw-Latn = tsw-Latn-NG
tsz = tsz-MX = tsz-Latn = tsz-Latn-MX
*tt = tt-RU = tt-Cyrl = tt-Cyrl-RU
tt-Latn = tt-Latn-RU
ttc = ttc-GT = ttc-Latn = ttc-Latn-GT
ttd = ttd-PG = *ttd-Latn = ttd-Latn-PG
tte = tte-PG = *tte-Latn = tte-Latn-PG
tth-Laoo = tth-Laoo-LA
ttj = ttj-UG = ttj-Latn = ttj-Latn-UG
tto-Laoo = tto-Laoo-LA
ttq-Arab = ttq-Arab-NE
*ttq-Latn = ttq-Latn-NE
*ttq-Tfng = ttq-Tfng-NE
*ttr-Latn = ttr-Latn-NG
tts = tts-TH = tts-Thai = tts-Thai-TH
ttt = ttt-AZ = ttt-Latn = ttt-Latn-AZ
ttt-Cyrl = ttt-Cyrl-AZ
ttu = ttu-PG = ttu-Latn = ttu-Latn-PG
ttv = ttv-PG = ttv-Latn = ttv-Latn-PG
tty-Latn = tty-Latn-ID
tua = tua-PG = tua-Latn = tua-Latn-PG
tuc = tuc-PG = tuc-Latn = tuc-Latn-PG
tue = tue-CO = tue-Latn = tue-Latn-CO
tuf = tuf-CO = tuf-Latn = tuf-Latn-CO
tuh = tuh-PG = tuh-Latn = tuh-Latn-PG
tui-Latn = tui-Latn-CM
*tul-Latn = tul-Latn-NG
tum = tum-MW = tum-Latn = tum-Latn-MW
tuo = tuo-BR = tuo-Latn = tuo-Latn-BR
*tuq-Latn = tuq-Latn-TD
tus-Latn = tus-Latn-CA
tuv = tuv-KE = tuv-Latn = tuv-Latn-KE
tuy = tuy-KE = tuy-Latn = tuy-Latn-KE
tuz-Latn = tuz-Latn-BF
*tvd-Latn = tvd-Latn-NG
tvk = tvk-VU = tvk-Latn = tvk-Latn-VU
tvl = tvl-TV = tvl-Latn = tvl-Latn-TV
tvl = tvl-TV = tvl-Latn = tvl-Latn-TV
tvo-Latn = tvo-Latn-ID
tvs = tvs-KE = tvs-Latn = tvs-Latn-KE
*tvu-Latn = tvu-Latn-CM
tvw-Latn = tvw-Latn-ID
tw = tw-GH = tw-Latn = tw-Latn-GH
twb-Latn = twb-Latn-PH
twd = twd-NL = twd-Latn = twd-Latn-NL
twf-Latn = twf-Latn-US
*twh-Latn = twh-Latn-VN
twh-Tavt = twh-Tavt-VN
twl-Latn = twl-Latn-MZ
twm-Deva = twm-Deva-IN
*twq = *twq-NE = twq-Latn = twq-Latn-NE
twu-Latn = twu-Latn-ID
twx-Latn = twx-Latn-MZ
twy-Latn = twy-Latn-ID
txa-Latn = txa-Latn-MY
txg-Tang = txg-Tang
txn-Latn = txn-Latn-ID
txo-Beng = txo-Beng-IN
txo-Deva = txo-Deva-IN
txq-Latn = txq-Latn-ID
txs-Latn = txs-Latn-ID
txt-Latn = txt-Latn-ID
txu = txu-BR = txu-Latn = txu-Latn-BR
txx-Latn = txx-Latn-MY
txy = txy-MG = txy-Latn = txy-Latn-MG
ty = ty-PF = ty-Latn = ty-Latn-PF
tya = tya-PG = tya-Latn = tya-Latn-PG
tye-Latn = tye-Latn-NG
tyi-Latn = tyi-Latn-CG
tyj-Latn = tyj-Latn-VN
tyj-x-taiyo-vn = tyj-x-taiyo-vn = tyj-x-taiyo-vn = tyj-x-taiyo-vn
tyn-Latn = tyn-Latn-ID
tyr-Tavt = tyr-Tavt-VN
tyt-Latn = tyt-Latn-VN
tyt-Tavt = tyt-Tavt-VN
tyv = tyv-RU = tyv-Cyrl = tyv-Cyrl-RU
tyx-Latn = tyx-Latn-CG
tyz-Latn = tyz-Latn-VN
tzh = tzh-MX = tzh-Latn = tzh-Latn-MX
tzj = tzj-GT = tzj-Latn = tzj-Latn-GT
*tzm = *tzm-MA = tzm-Latn = tzm-Latn-MA
tzm-Arab = tzm-Arab-MA
tzm-Tfng = tzm-Tfng-MA
tzn-Latn = tzn-Latn-ID
tzo = tzo-MX = tzo-Latn = tzo-Latn-MX
uar = uar-PG = uar-Latn = uar-Latn-PG
ubi-Latn = ubi-Latn-TD
ubl-Latn = ubl-Latn-PH
ubr = ubr-PG = ubr-Latn = ubr-Latn-PG
ubu = ubu-PG = *ubu-Latn = ubu-Latn-PG
ude-Cyrl = ude-Cyrl-RU
udi-Cyrl = udi-Cyrl-AZ
udl-Latn = udl-Latn-CM
udm = udm-RU = udm-Cyrl = udm-Cyrl-RU
udm-Latn = udm-Latn-RU
udu-Latn = udu-Latn-SD
*ug = *ug-CN = ug-Arab = ug-Arab-CN
*ug = ug-KZ = ug-Cyrl = ug-Cyrl-KZ
ug-Latn = ug-Latn-CN
ug-MN = ug-Cyrl-MN
uga = uga-SY = uga-Ugar = uga-Ugar-SY
uhn-Latn = uhn-Latn-ID
uis = uis-PG = uis-Latn = uis-Latn-PG
uiv-Latn = uiv-Latn-CM
*uk = uk-Cyrl
*uk = *uk-UA = uk-Cyrl = uk-Cyrl-UA
uk-MD = uk-Cyrl-MD
uk-SK = uk-Cyrl-SK
uli = uli-FM = uli-Latn = uli-Latn-FM
ulk = ulk-AU = ulk-Latn = ulk-Latn-AU
ulu-Latn = ulu-Latn-ID
umb = umb-AO = umb-Latn = umb-Latn-AO
umm-Latn = umm-Latn-NG
ums-Latn = ums-Latn-ID
umu-Latn = umu-Latn-CA
und-AQ = und-Latn-AQ
und-BV = und-Latn-BV
und-CP = und-Latn-CP
und-GS = und-Latn-GS
und-HM = und-Latn-HM
unr = unr-IN = unr-Beng = unr-Beng-IN
unr = unr-NP = unr-Deva = unr-Deva-NP
unr-Latn = unr-Latn-IN
unr-Orya = unr-Orya-IN
unx = unx-IN = unx-Beng = unx-Beng-IN
unx-Deva = unx-Deva-IN
upv = upv-VU = upv-Latn = upv-Latn-VU
*ur = ur-Arab
*ur = *ur-PK = ur-Arab = ur-Arab-PK
ur-Brai = ur-Brai-PK
*ur-IN = ur-Arab-IN
ur-MU = ur-Arab-MU
ura = ura-PE = ura-Latn = ura-Latn-PE
urb = urb-BR = urb-Latn = urb-Latn-BR
urg = urg-PG = urg-Latn = urg-Latn-PG
urh-Latn = urh-Latn-NG
uri = uri-PG = *uri-Latn = uri-Latn-PG
urk-Thai = urk-Thai-TH
uro = uro-PG = uro-Latn = uro-Latn-PG
urt = urt-PG = *urt-Latn = urt-Latn-PG
urw = urw-PG = *urw-Latn = urw-Latn-PG
ury-Latn = ury-Latn-ID
usa = usa-PG = *usa-Latn = usa-Latn-PG
usi-Beng = usi-Beng-BD
usi-Latn = usi-Latn-BD
usp = usp-GT = usp-Latn = usp-Latn-GT
ute-Latn = ute-Latn-US
utp = utp-SB = utp-Latn = utp-Latn-SB
*utr-Latn = utr-Latn-NG
uum-Cyrl = uum-Cyrl-GE
uum-Grek = uum-Grek-GE
uun-Latn = uun-Latn-TW
uve = uve-NC = uve-Latn = uve-Latn-NC
uvh = uvh-PG = *uvh-Latn = uvh-Latn-PG
uvl = uvl-PG = *uvl-Latn = uvl-Latn-PG
*uz = uz-AF = *uz-Arab = *uz-Arab-AF
*uz = uz-UZ = *uz-Latn = *uz-Latn-UZ
uz-CN = uz-Cyrl-CN
*uz-Cyrl = *uz-Cyrl-UZ
uzn-Arab = uzn-Arab-CN
uzn-Brai = uzn-Brai-UZ
uzn-Cyrl = uzn-Cyrl-UZ
uzn-Latn = uzn-Latn-CN
uzn-x-cn-sogdian = uzn-x-cn-sogdian = uzn-x-cn-sogdian = uzn-x-cn-sogdian
uzs-Arab = uzs-Arab-AF
vaa-Taml = vaa-Taml-IN
vaf-Arab = vaf-Arab-IR
*vag-Latn = vag-Latn-GH
vah-Deva = vah-Deva-IN
*vai = vai-LR = *vai-Vaii = *vai-Vaii-LR
*vai-Latn = *vai-Latn-LR
vam = vam-PG = vam-Latn = vam-Latn-PG
vap-Latn = vap-Latn-IN
var = var-MX = var-Latn = var-Latn-MX
vas-Deva = vas-Deva-IN
vas-Gujr = vas-Gujr-IN
vav-Deva = vav-Deva-IN
vav-Gujr = vav-Gujr-IN
vay-Deva = vay-Deva-NP
*ve = ve-Latn
*ve = *ve-ZA = ve-Latn = ve-Latn-ZA
ve-Brai = ve-Brai-ZA
vec = vec-IT = *vec-Latn = vec-Latn-IT
vem-Latn = vem-Latn-NG
vep = vep-RU = vep-Latn = vep-Latn-RU
ver-Latn = ver-Latn-NG
*vi = vi-Latn
*vi = *vi-VN = vi-Latn = vi-Latn-VN
vi-Brai = vi-Brai-VN
vi-Hani = vi-Hani-VN
vic = vic-SX = vic-Latn = vic-Latn-SX
vid = vid-TZ = vid-Latn = vid-Latn-TZ
viv = viv-PG = *viv-Latn = viv-Latn-PG
vkl-Latn = vkl-Latn-ID
vkp-Deva = vkp-Deva-IN
vkp-Latn = vkp-Latn-IN
vls = vls-BE = vls-Latn = vls-Latn-BE
vmc = vmc-MX = vmc-Latn = vmc-Latn-MX
vmf = vmf-DE = vmf-Latn = vmf-Latn-DE
vmg = vmg-PG = vmg-Latn = vmg-Latn-PG
vmj = vmj-MX = vmj-Latn = vmj-Latn-MX
vmk-Latn = vmk-Latn-MZ
vmm = vmm-MX = vmm-Latn = vmm-Latn-MX
vmp = vmp-MX = vmp-Latn = vmp-Latn-MX
vmw = vmw-MZ = vmw-Latn = vmw-Latn-MZ
vmx = vmx-MX = vmx-Latn = vmx-Latn-MX
vmy = vmy-MX = vmy-Latn = vmy-Latn-MX
vmz = vmz-MX = vmz-Latn = vmz-Latn-MX
*vo = *vo-001 = vo-Latn = vo-Latn-001
vot = vot-RU = vot-Latn = vot-Latn-RU
vro = vro-EE = vro-Latn = vro-Latn-EE
vrs = vrs-SB = vrs-Latn = vrs-Latn-SB
*vun = *vun-TZ = vun-Latn = vun-Latn-TZ
*vut-Latn = vut-Latn-CM
*wa = wa-BE = wa-Latn = wa-Latn-BE
wad-Latn = wad-Latn-ID
*wae = *wae-CH = wae-Latn = wae-Latn-CH
waj = waj-PG = *waj-Latn = waj-Latn-PG
wal = wal-ET = *wal-Ethi = wal-Ethi-ET
*wal-Latn = wal-Latn-ET
wam-Latn = wam-Latn-US
*wan-Latn = wan-Latn-CI
wap = wap-GY = wap-Latn = wap-Latn-GY
war = war-PH = war-Latn = war-Latn-PH
war-Brai = war-Brai-PH
was-Latn = was-Latn-US
wat = wat-PG = wat-Latn = wat-Latn-PG
wau = wau-BR = wau-Latn = wau-Latn-BR
waw = waw-BR = waw-Latn = waw-Latn-BR
way = way-SR = way-Latn = way-Latn-SR
wba = wba-VE = wba-Latn = wba-Latn-VE
wbf-Latn = wbf-Latn-BF
wbi = wbi-TZ = wbi-Latn = wbi-Latn-TZ
wbj = wbj-TZ = wbj-Latn = wbj-Latn-TZ
wbl = wbl-AF = wbl-Arab = wbl-Arab-AF
wbl-Cyrl = wbl-Cyrl-TJ
wbl-Latn = wbl-Latn-TJ
wbm-Latn = wbm-Latn-CN
wbp = wbp-AU = wbp-Latn = wbp-Latn-AU
wbq = wbq-IN = wbq-Telu = wbq-Telu-IN
wbr = wbr-IN = wbr-Deva = wbr-Deva-IN
wca = wca-BR = wca-Latn = wca-Latn-BR
*wci-Latn = wci-Latn-TG
wec-Latn = wec-Latn-CI
wed = wed-PG = wed-Latn = wed-Latn-PG
weh-Latn = weh-Latn-CM
wei = wei-PG = wei-Latn = wei-Latn-PG
weo-Latn = weo-Latn-ID
wep-Latn = wep-Latn-DE
wer = wer-PG = *wer-Latn = wer-Latn-PG
wes-Latn = wes-Latn-CM
weu-Latn = weu-Latn-MM
wew-Latn = wew-Latn-ID
wgi = wgi-PG = *wgi-Latn = wgi-Latn-PG
whg = whg-PG = *whg-Latn = whg-Latn-PG
*wib-Latn = wib-Latn-BF
wii = wii-PG = wii-Latn = wii-Latn-PG
wim = wim-AU = wim-Latn = wim-Latn-AU
win-Latn = win-Latn-US
wiu = wiu-PG = *wiu-Latn = wiu-Latn-PG
wiv = wiv-PG = *wiv-Latn = wiv-Latn-PG
wiy-Latn = wiy-Latn-US
*wja-Latn = wja-Latn-NG
*wji-Latn = wji-Latn-NG
wlo-Arab = wlo-Arab-ID
wls = wls-WF = wls-Latn = wls-Latn-WF
wlv = wlv-AR = wlv-Latn = wlv-Latn-AR
wlw-Latn = wlw-Latn-ID
wlx-Latn = wlx-Latn-GH
wmd = wmd-BR = wmd-Latn = wmd-Latn-BR
wme-Deva = wme-Deva-NP
wmh-Latn = wmh-Latn-TL
wmo = wmo-PG = wmo-Latn = wmo-Latn-PG
wms-Latn = wms-Latn-ID
wmt = wmt-AU = wmt-Latn = wmt-Latn-AU
wmw-Arab = wmw-Arab-MZ
wmw-Latn = wmw-Latn-MZ
wnc = wnc-PG = *wnc-Latn = wnc-Latn-PG
wni = wni-KM = wni-Arab = wni-Arab-KM
wni-Latn = wni-Latn-KM
wno-Latn = wno-Latn-ID
wnu = wnu-PG = *wnu-Latn = wnu-Latn-PG
wo = wo-SN = *wo-Latn = wo-Latn-SN
*wo-Arab = wo-Arab-SN
*wob-Latn = wob-Latn-CI
wod-Latn = wod-Latn-ID
woe-Wole = woe-Wole-FM
wof-Latn = wof-Latn-GM
won-Latn = won-Latn-CD
woo-Latn = woo-Latn-ID
wos = wos-PG = *wos-Latn = wos-Latn-PG
wra = wra-PG = wra-Latn = wra-Latn-PG
wrk = wrk-AU = wrk-Latn = wrk-Latn-AU
wro = wro-AU = wro-Latn = wro-Latn-AU
wrs = wrs-PG = *wrs-Latn = wrs-Latn-PG
wsg-Telu = wsg-Telu-IN
wsk = wsk-PG = *wsk-Latn = wsk-Latn-PG
wss-Latn = wss-Latn-GH
wti-Latn = wti-Latn-ET
wtk = wtk-PG = wtk-Latn = wtk-Latn-PG
wtm = wtm-IN = wtm-Deva = wtm-Deva-IN
wul-Latn = wul-Latn-ID
wuu = wuu-CN = wuu-Hans = wuu-Hans-CN
wuu-Hant = wuu-Hant-CN
wuu-Latn = wuu-Latn-CN
wuv = wuv-PG = *wuv-Latn = wuv-Latn-PG
*wwa-Latn = wwa-Latn-BJ
wwo = wwo-VU = wwo-Latn = wwo-Latn-VU
wym-Latn = wym-Latn-PL
xal-Cyrl = xal-Cyrl-RU
xal-Mong-x-todo = xal-Mong-CN-x-todo
xan-Ethi = xan-Ethi-ET
xav = xav-BR = xav-Latn = xav-Latn-BR
xbi = xbi-PG = *xbi-Latn = xbi-Latn-PG
xbr-Latn = xbr-Latn-ID
xcr = xcr-TR = xcr-Cari = xcr-Cari-TR
xed-Latn = xed-Latn-CM
xer = xer-BR = xer-Latn = xer-Latn-BR
xes = xes-PG = xes-Latn = xes-Latn-PG
*xh = xh-Latn
*xh = xh-ZA = xh-Latn = xh-Latn-ZA
xh-Brai = xh-Brai-ZA
xis-Orya = xis-Orya-IN
xkd-Latn = xkd-Latn-ID
xkf-Tibt-x-uchen = xkf-Tibt-BT-x-uchen
xkj-Arab = xkj-Arab-IR
xkl-Latn = xkl-Latn-ID
xkv = xkv-BW = xkv-Latn = xkv-Latn-BW
xkz-Latn = xkz-Latn-BT
xkz-Tibt = xkz-Tibt-BT
xla = xla-PG = *xla-Latn = xla-Latn-PG
xlc = xlc-TR = xlc-Lyci = xlc-Lyci-TR
xld = xld-TR = xld-Lydi = xld-Lydi-TR
xmd-Latn = xmd-Latn-CM
xmf = xmf-GE = xmf-Geor = xmf-Geor-GE
xmg-Qabh = xmg-Qabh-CM
xmm-Latn = xmm-Latn-ID
xmn = xmn-CN = xmn-Mani = xmn-Mani-CN
xmr = xmr-SD = xmr-Merc = xmr-Merc-SD
xmr-Mero = xmr-Mero-SD
xmv = xmv-MG = xmv-Latn = xmv-Latn-MG
xmw = xmw-MG = xmw-Latn = xmw-Latn-MG
xmz-Latn = xmz-Latn-ID
xna = xna-SA = xna-Narb = xna-Narb-SA
xnn-Latn = xnn-Latn-PH
xnr = xnr-IN = xnr-Deva = xnr-Deva-IN
xnz-Arab = xnz-Arab-EG
xnz-Copt-x-oldnubian = xnz-Copt-EG-x-oldnubian
xnz-Latn = xnz-Latn-EG
*xog = *xog-UG = xog-Latn = xog-Latn-UG
xok = xok-BR = xok-Latn = xok-Latn-BR
xom-Latn = xom-Latn-SD
xon-Brai = xon-Brai-GH
*xon-Latn = xon-Latn-GH
xpe = xpe-LR = *xpe-Latn = xpe-Latn-LR
xpe-Kpel = xpe-Kpel-LR
xpr = xpr-IR = xpr-Prti = xpr-Prti-IR
xra = xra-BR = xra-Latn = xra-Latn-BR
*xrb-Latn = xrb-Latn-BF
xsa = xsa-YE = xsa-Sarb = xsa-Sarb-YE
xsb-Latn = xsb-Latn-PH
xsi = xsi-PG = *xsi-Latn = xsi-Latn-PG
xsl-Cans = xsl-Cans-CA
xsl-Latn = xsl-Latn-CA
*xsm-Latn = xsm-Latn-BF
xsr = xsr-NP = xsr-Deva = xsr-Deva-NP
xsr-Tibt = xsr-Tibt-CN
xsu = xsu-VE = xsu-Latn = xsu-Latn-VE
xsy-Latn = xsy-Latn-TW
xta = xta-MX = xta-Latn = xta-Latn-MX
xtc-Latn = xtc-Latn-SD
xtd = xtd-MX = xtd-Latn = xtd-Latn-MX
xte-Latn = xte-Latn-ID
xti = xti-MX = xti-Latn = xti-Latn-MX
xtj = xtj-MX = xtj-Latn = xtj-Latn-MX
xtl = xtl-MX = xtl-Latn = xtl-Latn-MX
xtm = xtm-MX = xtm-Latn = xtm-Latn-MX
xtn = xtn-MX = xtn-Latn = xtn-Latn-MX
xtt = xtt-MX = xtt-Latn = xtt-Latn-MX
xtu = xtu-MX = xtu-Latn = xtu-Latn-MX
xty = xty-MX = xty-Latn = xty-Latn-MX
xub-Knda = xub-Knda-IN
xub-Mlym = xub-Mlym-IN
xub-Taml = xub-Taml-IN
xum-Ital = xum-Ital-IT
xum-Latn = xum-Latn-IT
xuo-Latn = xuo-Latn-TD
xuu-Latn = xuu-Latn-NA
*xwe-Latn = xwe-Latn-BJ
xxk-Latn = xxk-Latn-ID
yaa = yaa-PE = yaa-Latn = yaa-Latn-PE
yab = yab-BR = yab-Latn = yab-Latn-BR
yac-Latn = yac-Latn-ID
yad = yad-PE = yad-Latn = yad-Latn-PE
yae = yae-VE = yae-Latn = yae-Latn-VE
yaf-Latn = yaf-Latn-CD
yag = yag-CL = yag-Latn = yag-Latn-CL
yah-Cyrl = yah-Cyrl-TJ
yah-Latn = yah-Latn-TJ
yai-Cyrl = yai-Cyrl-TJ
yal-Arab = yal-Arab-GN
yal-Latn = yal-Latn-GN
*yam-Latn = yam-Latn-CM
yan = yan-NI = yan-Latn = yan-Latn-NI
yao = yao-MZ = yao-Latn = yao-Latn-MZ
yap = yap-FM = yap-Latn = yap-Latn-FM
yaq = yaq-MX = yaq-Latn = yaq-Latn-MX
*yas-Latn = yas-Latn-CM
*yat-Latn = yat-Latn-CM
yau = yau-VE = yau-Latn = yau-Latn-VE
*yav = *yav-CM = yav-Latn = yav-Latn-CM
yax-Latn = yax-Latn-AO
*yay-Latn = yay-Latn-NG
*yaz-Latn = yaz-Latn-NG
*yba-Latn = yba-Latn-NG
ybb = ybb-CM = *ybb-Latn = ybb-Latn-CM
ybh-Deva = ybh-Deva-NP
ybi-Deva = ybi-Deva-NP
ybo = ybo-PG = ybo-Latn = ybo-Latn-PG
yby = yby-PG = *yby-Latn = yby-Latn-PG
ycn = ycn-CO = ycn-Latn = ycn-Latn-CO
ydd-Hebr = ydd-Hebr-UA
yde = yde-PG = yde-Latn = yde-Latn-PG
ydg-Arab = ydg-Arab-PK
yea-Knda = yea-Knda-IN
yea-Mlym = yea-Mlym-IN
*yer-Latn = yer-Latn-NG
yes-Latn = yes-Latn-NG
yeu-Telu = yeu-Telu-IN
yey = yey-BW = yey-Latn = yey-Latn-BW
ygp-Plrd = ygp-Plrd-CN
ygr = ygr-PG = *ygr-Latn = ygr-Latn-PG
ygw = ygw-PG = *ygw-Latn = ygw-Latn-PG
yhd-Hebr = yhd-Hebr-IL
*yi = *yi-001 = yi-Hebr = yi-Hebr-001
*yi = yi-Hebr
yi-CA = yi-Hebr-CA
yi-GB = yi-Hebr-GB
yi-SE = yi-Hebr-SE
yi-UA = yi-Hebr-UA
yi-US = yi-Hebr-US
yig-Yiii-x-traditional = yig-Yiii-CN-x-traditional
yih-Hebr = yih-Hebr-DE
yij = yij-AU = yij-Latn = yij-Latn-AU
yim-Latn = yim-Latn-IN
yka-Arab = yka-Arab-PH
yka-Latn = yka-Latn-PH
ykg-Cyrl = ykg-Cyrl-RU
*yko-Latn = yko-Latn-CM
ykr = ykr-PG = ykr-Latn = ykr-Latn-PG
yle = yle-PG = *yle-Latn = yle-Latn-PG
ylg = ylg-PG = ylg-Latn = ylg-Latn-PG
yli-Latn = yli-Latn-ID
yll = yll-PG = yll-Latn = yll-Latn-PG
yml = yml-PG = *yml-Latn = yml-Latn-PG
ymm-Latn = ymm-Latn-SO
ymn-Latn = ymn-Latn-ID
ynk-Cyrl = ynk-Cyrl-RU
yns-Latn = yns-Latn-CD
*yo = *yo-NG = yo-Latn = yo-Latn-NG
*yo-Arab = yo-Arab-NG
yo-Brai = yo-Brai-NG
yog-Latn = yog-Latn-PH
yom-Latn = yom-Latn-CD
yon = yon-PG = *yon-Latn = yon-Latn-PG
yrb = yrb-PG = *yrb-Latn = yrb-Latn-PG
*yre-Latn = yre-Latn-CI
yrk-Cyrl = yrk-Cyrl-RU
yrl = yrl-BR = yrl-Latn = yrl-Latn-BR
ysd-Yiii = ysd-Yiii-CN
ysn-Yiii-x-traditional = ysn-Yiii-CN-x-traditional
yss = yss-PG = *yss-Latn = yss-Latn-PG
ysy-Plrd = ysy-Plrd-CN
yua = yua-MX = yua-Latn = yua-Latn-MX
yud-Hebr = yud-Hebr-IL
yue-Brai = yue-Brai-CN
yue-Hans = yue-Hans-CN
yue-Hant = yue-Hant-CN
yue-Latn = yue-Latn-CN
yuf-Latn = yuf-Latn-US
yui = yui-CO = yui-Latn = yui-Latn-CO
yuj = yuj-PG = *yuj-Latn = yuj-Latn-PG
yun-Latn = yun-Latn-NG
yup = yup-CO = yup-Latn = yup-Latn-CO
yuq = yuq-BO = yuq-Latn = yuq-Latn-BO
yur-Latn = yur-Latn-US
yut = yut-PG = *yut-Latn = yut-Latn-PG
yuw = yuw-PG = *yuw-Latn = yuw-Latn-PG
yuz = yuz-BO = yuz-Latn = yuz-Latn-BO
yva-Latn = yva-Latn-ID
ywq-Plrd = ywq-Plrd-CN
ywq-Yiii-x-traditional = ywq-Yiii-CN-x-traditional
za = za-CN = za-Latn = za-Latn-CN
zaa = zaa-MX = zaa-Latn = zaa-Latn-MX
zab = zab-MX = zab-Latn = zab-Latn-MX
zac = zac-MX = zac-Latn = zac-Latn-MX
zad = zad-MX = zad-Latn = zad-Latn-MX
zae = zae-MX = zae-Latn = zae-Latn-MX
zaf = zaf-MX = zaf-Latn = zaf-Latn-MX
zag = zag-SD = zag-Latn = zag-Latn-SD
zag-beria-sd = zag-beria-sd
zai = zai-MX = zai-Latn = zai-Latn-MX
zaj = zaj-TZ = zaj-Latn = zaj-Latn-TZ
zak = zak-TZ = zak-Latn = zak-Latn-TZ
zam = zam-MX = zam-Latn = zam-Latn-MX
zao = zao-MX = zao-Latn = zao-Latn-MX
zap = zap-MX = zap-Latn = zap-Latn-MX
zaq = zaq-MX = zaq-Latn = zaq-Latn-MX
zar = zar-MX = zar-Latn = zar-Latn-MX
zas = zas-MX = zas-Latn = zas-Latn-MX
zat = zat-MX = zat-Latn = zat-Latn-MX
zau-Tibt = zau-Tibt-IN
zav = zav-MX = zav-Latn = zav-Latn-MX
zaw = zaw-MX = zaw-Latn = zaw-Latn-MX
*zay-Latn = zay-Latn-ET
zbl = zbl-?? = zbl-Blis = zbl-Blis-??
zbl = zbl-Blis
zbw-Latn = zbw-Latn-MY
zca = zca-MX = zca-Latn = zca-Latn-MX
zch-Hani = zch-Hani-CN
zdj = zdj-KM = *zdj-Arab = zdj-Arab-KM
zdj-Latn = zdj-Latn-KM
zea = zea-NL = zea-Latn = zea-Latn-NL
zeh-Hani = zeh-Hani-CN
zen-Tfng = zen-Tfng-MR
zga = zga-TZ = zga-Latn = zga-Latn-TZ
zgb-Hani = zgb-Hani-CN
*zgh = *zgh-MA = zgh-Tfng = zgh-Tfng-MA
zgm-Hani = zgm-Hani-CN
zgn-Hani = zgn-Hani-CN
*zh = zh-CN = *zh-Hans = *zh-Hans-CN
*zh = zh-TW = *zh-Hant = *zh-Hant-TW
zh-AU = zh-Hant-AU
zh-BN = zh-Hant-BN
zh-Bopo = zh-Bopo-TW
zh-GB = zh-Hant-GB
zh-GF = zh-Hant-GF
zh-HK = *zh-Hant-HK
zh-Hani = zh-Hani-CN
zh-ID = zh-Hant-ID
zh-MO = *zh-Hant-MO
zh-MY = zh-Hant-MY
zh-PA = zh-Hant-PA
zh-PF = zh-Hant-PF
zh-PH = zh-Hant-PH
zh-Phag = zh-Phag-CN
zh-SR = zh-Hant-SR
zh-TH = zh-Hant-TH
zh-US = zh-Hant-US
zh-VN = zh-Hant-VN
zhd-Hani = zhd-Hani-CN
zhd-Latn = zhd-Latn-VN
zhn-Hani = zhn-Hani-CN
zhn-Latn = zhn-Latn-CN
zia = zia-PG = *zia-Latn = zia-Latn-PG
zik = zik-PG = zik-Latn = zik-Latn-PG
zim-Latn = zim-Latn-TD
zin = zin-TZ = zin-Latn = zin-Latn-TZ
ziw = ziw-TZ = ziw-Latn = ziw-Latn-TZ
zkd-Latn = zkd-Latn-MM
zlj-Hani = zlj-Hani-CN
zlj-Latn = zlj-Latn-CN
*zlm-Arab = zlm-Arab-MY
zlm-Latn = zlm-Latn-MY
zln-Hani = zln-Hani-CN
zlq-Hani = zlq-Hani-CN
zmi = zmi-MY = zmi-Latn = zmi-Latn-MY
zmp-Latn = zmp-Latn-CD
zmz-Latn = zmz-Latn-CD
zna-Latn = zna-Latn-TD
*zne-Latn = zne-Latn-CD
zoc = zoc-MX = zoc-Latn = zoc-Latn-MX
zoh = zoh-MX = zoh-Latn = zoh-Latn-MX
zom-Latn = zom-Latn-IN
zor = zor-MX = zor-Latn = zor-Latn-MX
zos = zos-MX = zos-Latn = zos-Latn-MX
zpa = zpa-MX = zpa-Latn = zpa-Latn-MX
zpc = zpc-MX = zpc-Latn = zpc-Latn-MX
zpf = zpf-MX = zpf-Latn = zpf-Latn-MX
zpg = zpg-MX = zpg-Latn = zpg-Latn-MX
zpi = zpi-MX = zpi-Latn = zpi-Latn-MX
zpl = zpl-MX = zpl-Latn = zpl-Latn-MX
zpm = zpm-MX = zpm-Latn = zpm-Latn-MX
zpn = zpn-MX = zpn-Latn = zpn-Latn-MX
zpo = zpo-MX = zpo-Latn = zpo-Latn-MX
zpq = zpq-MX = zpq-Latn = zpq-Latn-MX
zpr = zpr-MX = zpr-Latn = zpr-Latn-MX
zpt = zpt-MX = zpt-Latn = zpt-Latn-MX
zpu = zpu-MX = zpu-Latn = zpu-Latn-MX
zpv = zpv-MX = zpv-Latn = zpv-Latn-MX
zpw = zpw-MX = zpw-Latn = zpw-Latn-MX
zpx = zpx-MX = zpx-Latn = zpx-Latn-MX
zpy = zpy-MX = zpy-Latn = zpy-Latn-MX
zpz = zpz-MX = zpz-Latn = zpz-Latn-MX
zqe-Hani = zqe-Hani-CN
zqe-Latn = zqe-Latn-CN
zrg-Orya = zrg-Orya-IN
zrg-Telu = zrg-Telu-IN
zrn-Latn = zrn-Latn-TD
zrs-Latn = zrs-Latn-ID
*zsm-Arab = zsm-Arab-MY
zsm-Brai = zsm-Brai-MY
zsm-Latn = zsm-Latn-MY
zsr = zsr-MX = zsr-Latn = zsr-Latn-MX
ztg = ztg-MX = ztg-Latn = ztg-Latn-MX
ztn = ztn-MX = ztn-Latn = ztn-Latn-MX
ztp = ztp-MX = ztp-Latn = ztp-Latn-MX
ztq = ztq-MX = ztq-Latn = ztq-Latn-MX
zts = zts-MX = zts-Latn = zts-Latn-MX
ztu = ztu-MX = ztu-Latn = ztu-Latn-MX
zty = zty-MX = zty-Latn = zty-Latn-MX
*zu = zu-Latn
*zu = *zu-ZA = zu-Latn = zu-Latn-ZA
zu-Brai = zu-Brai-ZA
zuh = zuh-PG = zuh-Latn = zuh-Latn-PG
zun-Latn = zun-Latn-US
zyb-Hani = zyb-Hani-CN
zyb-Latn = zyb-Latn-CN
zyg-Hani = zyg-Hani-CN
zyg-Nshu = zyg-Nshu-CN
zyj-Hani = zyj-Hani-CN
zyj-Latn = zyj-Latn-CN
zyn-Hani = zyn-Hani-CN
zyp-Latn = zyp-Latn-MM
zza = zza-TR = zza-Latn = zza-Latn-TR
zza-Arab = zza-Arab-TR
zzj-Hani = zzj-Hani-CN
